Rk,Player,Team,Conf,G,Att,Yds,Y/A,TD,Y/G,Rec,Yds,Y/R,TD,Y/G,Plays,Yds,Avg,TD,Awards,-9999
1,Ashton Jeanty,Boise State,MWC,14,374,2601,7.0,29,185.8,23,138,6.0,1,9.9,397,2739,6.9,30,H-2MaxwellAA,ashton-jeanty-1
2,Cameron Skattebo,Arizona State,Big 12,13,293,1711,5.8,21,131.6,45,605,13.4,3,46.5,338,2316,6.9,24,H-5,cameron-skattebo-1
3,Omarion Hampton*,North Carolina,ACC,12,281,1660,5.9,15,138.3,38,373,9.8,2,31.1,319,2033,6.4,17,,omarion-hampton-1
4,Bryson Daily*,Army,American,13,310,1659,5.4,32,127.6,0,0,,0,0.0,310,1659,5.4,32,H-6,bryson-daily-1
5,Tre Stewart*,Jacksonville State,CUSA,14,278,1638,5.9,25,117.0,18,234,13.0,1,16.7,296,1872,6.3,26,,tre-stewart-1
6,R.J. Harvey,UCF,Big 12,12,232,1577,6.8,22,131.4,20,267,13.4,3,22.3,252,1844,7.3,25,,rj-harvey-1
7,Kaleb Johnson*,Iowa,Big Ten,12,240,1537,6.4,21,128.1,22,188,8.5,2,15.7,262,1725,6.6,23,AA,kaleb-johnson-2
8,Tahj Brooks*,Texas Tech,Big 12,11,286,1505,5.3,17,136.8,28,199,7.1,1,18.1,314,1704,5.4,18,,tahj-brooks-1
9,Dylan Sampson,Tennessee,SEC,13,258,1491,5.8,22,114.7,20,143,7.2,0,11.0,278,1634,5.9,22,,dylan-sampson-1
10,Makhi Hughes*,Tulane,American,14,265,1401,5.3,15,100.1,19,176,9.3,2,12.6,284,1577,5.6,17,,makhi-hughes-1
11,Mario Anderson*,Memphis,American,13,236,1362,5.8,18,104.8,52,312,6.0,3,24.0,288,1674,5.8,21,,mario-anderson-1
12,Ahmad Hardy,Louisiana-Monroe,Sun Belt,12,237,1351,5.7,13,112.6,8,72,9.0,0,6.0,245,1423,5.8,13,,ahmad-hardy-1
13,Tyler Huff*,Jacksonville State,CUSA,14,227,1344,5.9,15,96.0,0,0,,0,0.0,227,1344,5.9,15,,tyler-huff-1
14,DJ Giddens*,Kansas State,Big 12,12,205,1343,6.6,7,111.9,21,258,12.3,1,21.5,226,1601,7.1,8,,dj-giddens-1
15,Brashard Smith,SMU,ACC,14,235,1332,5.7,14,95.1,39,327,8.4,4,23.4,274,1659,6.1,18,,brashard-smith-1
16,Kyle Monangai*,Rutgers,Big Ten,11,256,1279,5.0,13,116.3,14,75,5.4,1,6.8,270,1354,5.0,14,,kyle-monangai-1
17,Marquez Cooper,San Diego State,MWC,12,292,1274,4.4,12,106.2,20,137,6.9,2,11.4,312,1411,4.5,14,,marquez-cooper-1
18,Jordan James,Oregon,Big Ten,14,233,1267,5.4,15,90.5,26,209,8.0,0,14.9,259,1476,5.7,15,,jordan-james-3
19,Devin Neal,Kansas,Big 12,12,219,1266,5.8,16,105.5,24,254,10.6,1,21.2,243,1520,6.3,17,,devin-neal-3
20,Quinton Cooley*,Liberty,CUSA,11,205,1254,6.1,13,114.0,1,9,9.0,0,0.8,206,1263,6.1,13,,quinton-cooley-1
21,Blake Horvath*,Navy,American,12,175,1246,7.1,17,103.8,1,13,13.0,0,1.1,176,1259,7.2,17,,blake-horvath-1
22,Anthony Tyus III*,Ohio,MAC,13,237,1215,5.1,9,93.5,16,137,8.6,2,10.5,253,1352,5.3,11,,anthony-tyus-iii-1
23,Jarquez Hunter,Auburn,SEC,12,187,1201,6.4,8,100.1,21,155,7.4,1,12.9,208,1356,6.5,9,,jarquez-hunter-1
24,Isaac Brown*,Louisville,ACC,13,165,1173,7.1,11,90.2,30,152,5.1,1,11.7,195,1325,6.8,12,,isaac-brown-4
25,Devon Dampier,New Mexico,MWC,12,155,1166,7.5,19,97.2,0,0,,0,0.0,155,1166,7.5,19,,devon-dampier-1
26,Rahjai Harris*,East Carolina,American,13,206,1166,5.7,11,89.7,15,91,6.1,0,7.0,221,1257,5.7,11,,rahjai-harris-1
27,Bhayshul Tuten*,Virginia Tech,ACC,11,183,1159,6.3,15,105.4,23,81,3.5,2,7.4,206,1240,6.0,17,,bhayshul-tuten-1
28,Corey Kiner,Cincinnati,Big 12,12,204,1153,5.7,4,96.1,16,111,6.9,0,9.3,220,1264,5.7,4,,corey-kiner-1
29,Jo'quavious Marks*,USC,Big Ten,12,198,1133,5.7,9,94.4,47,321,6.8,0,26.8,245,1454,5.9,9,,joquavious-marks-1
30,Jeremiyah Love*,Notre Dame,Ind,16,163,1125,6.9,17,70.3,28,237,8.5,2,14.8,191,1362,7.1,19,,jeremiyah-love-1
31,Kanye Udoh*,Army,American,13,179,1117,6.2,10,85.9,1,3,3.0,0,0.2,180,1120,6.2,10,,kanye-udoh-1
32,Phil Mafah,Clemson,ACC,14,216,1115,5.2,8,79.6,21,103,4.9,0,7.4,237,1218,5.1,8,,phil-mafah-1
33,Rahsul Faison,Utah State,MWC,12,198,1109,5.6,8,92.4,22,99,4.5,0,8.3,220,1208,5.5,8,,rahsul-faison-1
34,Kaytron Allen*,Penn State,Big Ten,16,220,1108,5.0,8,69.3,18,153,8.5,2,9.6,238,1261,5.3,10,,kaytron-allen-1
35,Nicholas Singleton*,Penn State,Big Ten,15,172,1099,6.4,12,73.3,41,375,9.1,5,25.0,213,1474,6.9,17,,nicholas-singleton-1
36,Keyon Mozee*,Miami (OH),MAC,14,178,1098,6.2,4,78.4,1,2,2.0,0,0.1,179,1100,6.1,4,,keyon-mozee-1
37,Anthony Hankerson,Oregon State,Ind,12,232,1082,4.7,15,90.2,27,151,5.6,0,12.6,259,1233,4.8,15,,anthony-hankerson-1
38,Al-Jay Henderson*,Buffalo,MAC,13,204,1078,5.3,9,82.9,19,238,12.5,1,18.3,223,1316,5.9,10,,al-jay-henderson-1
39,Tre Wisner*,Texas,SEC,15,226,1064,4.7,5,70.9,44,311,7.1,1,20.7,270,1375,5.1,6,,tre-wisner-1
40,Eli Sanders,New Mexico,MWC,12,147,1063,7.2,9,88.6,15,134,8.9,0,11.2,162,1197,7.4,9,,eli-sanders-2
41,Quinshon Judkins*,Ohio State,Big Ten,16,194,1060,5.5,14,66.3,22,161,7.3,2,10.1,216,1221,5.7,16,,quinshon-judkins-1
42,Jonah Coleman*,Washington,Big Ten,13,193,1053,5.5,10,81.0,23,177,7.7,0,13.6,216,1230,5.7,10,,jonah-coleman-1
43,Demond Claiborne,Wake Forest,ACC,12,228,1049,4.6,11,87.4,23,254,11.0,2,21.2,251,1303,5.2,13,,demond-claiborne-1
44,Parker Navarro*,Ohio,MAC,13,160,1046,6.5,18,80.5,0,0,,0,0.0,160,1046,6.5,18,,parker-navarro-1
45,Bryson Washington*,Baylor,Big 12,11,175,1028,5.9,12,93.5,22,217,9.9,1,19.7,197,1245,6.3,13,,bryson-washington-3
46,LeQuint Allen*,Syracuse,ACC,13,228,1021,4.5,16,78.5,64,521,8.1,4,40.1,292,1542,5.3,20,,lequint-allen-1
47,TreVeyon Henderson*,Ohio State,Big Ten,16,144,1016,7.1,10,63.5,27,284,10.5,1,17.8,171,1300,7.6,11,,treveyon-henderson-1
48,Damien Taylor,Troy,Sun Belt,12,173,1010,5.8,7,84.2,3,19,6.3,1,1.6,176,1029,5.8,8,,damien-taylor-2
49,Micah Bernard,Utah,Big 12,12,197,1009,5.1,4,84.1,30,150,5.0,2,12.5,227,1159,5.1,6,,micah-bernard-1
50,Avery Morrow*,Colorado State,MWC,13,184,1006,5.5,9,77.4,16,102,6.4,0,7.8,200,1108,5.5,9,,avery-morrow-1
51,Damien Martinez*,Miami (FL),ACC,13,159,1002,6.3,10,77.1,17,204,12.0,0,15.7,176,1206,6.9,10,,damien-martinez-1
52,Ismail Mahdi*,Texas State,Sun Belt,12,183,991,5.4,4,82.6,24,195,8.1,2,16.3,207,1186,5.7,6,,ismail-mahdi-1
53,Darius Taylor*,Minnesota,Big Ten,12,205,986,4.8,10,82.2,54,350,6.5,2,29.2,259,1336,5.2,12,,darius-taylor-1
54,George Pettaway*,James Madison,Sun Belt,13,162,980,6.0,5,75.4,24,200,8.3,2,15.4,186,1180,6.3,7,,george-pettaway-1
55,Desmond Reid*,Pitt,ACC,11,184,966,5.3,5,87.8,52,579,11.1,4,52.6,236,1545,6.5,9,,desmond-reid-1
56,Kalel Mullings*,Michigan,Big Ten,12,185,948,5.1,12,79.0,6,35,5.8,0,2.9,191,983,5.1,12,,kalel-mullings-1
57,Jamal Haynes*,Georgia Tech,ACC,13,169,944,5.6,9,72.6,28,166,5.9,3,12.8,197,1110,5.6,12,,jamal-haynes-1
58,Jaden Nixon*,Western Michigan,MAC,13,143,919,6.4,12,70.7,10,77,7.7,0,5.9,153,996,6.5,12,,jaden-nixon-1
59,Jai'Den Thomas*,Nevada-Las Vegas,MWC,14,164,918,5.6,7,65.6,11,91,8.3,1,6.5,175,1009,5.8,8,,jaiden-thomas-1
60,Riley Leonard*,Notre Dame,Ind,16,184,906,4.9,17,56.6,1,-8,-8.0,0,-0.5,185,898,4.9,17,,riley-leonard-1
61,Terion Stewart*,Bowling Green,MAC,11,166,898,5.4,6,81.6,1,12,12.0,0,1.1,167,910,5.4,6,,terion-stewart-1
62,Aaron Young,Old Dominion,Sun Belt,11,172,887,5.2,8,80.6,9,71,7.9,0,6.5,181,958,5.3,8,,aaron-young-5
63,Lee Beebe,UAB,American,12,166,884,5.3,7,73.7,30,219,7.3,1,18.3,196,1103,5.6,8,,lee-beebe-1
64,Elijah Young*,Western Kentucky,CUSA,14,201,883,4.4,3,63.1,47,384,8.2,2,27.4,248,1267,5.1,5,,elijah-young-1
65,Raheim Sanders*,South Carolina,SEC,12,183,881,4.8,11,73.4,27,316,11.7,2,26.3,210,1197,5.7,13,,raheim-sanders-1
66,Ollie Gordon,Oklahoma State,Big 12,12,190,880,4.6,13,73.3,29,179,6.2,1,14.9,219,1059,4.8,14,,ollie-gordon-1
67,Star Thomas*,Duke,ACC,12,213,871,4.1,7,72.6,20,153,7.7,1,12.8,233,1024,4.4,8,,star-thomas-2
68,A.J. Turner,Marshall,Sun Belt,11,104,864,8.3,6,78.5,8,68,8.5,2,6.2,112,932,8.3,8,,aj-turner-3
69,Tawee Walker,Wisconsin,Big Ten,11,190,864,4.5,10,78.5,11,21,1.9,0,1.9,201,885,4.4,10,,tawee-walker-1
70,Hajj-Malik Williams*,Nevada-Las Vegas,MWC,13,161,851,5.3,9,65.5,0,0,,0,0.0,161,851,5.3,9,,hajj-malik-williams-1
71,Justice Ellison,Indiana,Big Ten,13,159,848,5.3,10,65.2,13,90,6.9,0,6.9,172,938,5.5,10,,justice-ellison-1
72,CJ Campbell,Florida Atlantic,American,12,165,844,5.1,11,70.3,40,466,11.7,3,38.8,205,1310,6.4,14,,cj-campbell-1
73,Jahiem White*,West Virginia,Big 12,13,148,844,5.7,7,64.9,19,122,6.4,1,9.4,167,966,5.8,8,,jahiem-white-1
74,Fluff Bothwell*,South Alabama,Sun Belt,12,111,832,7.5,13,69.3,13,92,7.1,0,7.7,124,924,7.5,13,,fluff-bothwell-1
75,Kentrel Bullock*,South Alabama,Sun Belt,13,152,831,5.5,7,63.9,15,153,10.2,1,11.8,167,984,5.9,8,,kentrel-bullock-2
76,Camryn Edwards*,Connecticut,Ind,13,146,830,5.7,8,63.8,13,148,11.4,2,11.4,159,978,6.2,10,,camryn-edwards-1
77,John Mateer*,Washington State,Ind,12,178,826,4.6,15,68.8,0,21,,0,1.8,178,847,4.8,15,,john-mateer-1
78,Seth McGowan,New Mexico State,CUSA,12,152,823,5.4,3,68.6,23,277,12.0,3,23.1,175,1100,6.3,6,,seth-mcgowan-1
79,Freddie Brock,Georgia State,Sun Belt,12,151,819,5.4,8,68.3,21,166,7.9,1,13.8,172,985,5.7,9,,freddie-brock-1
80,Nate Noel*,Missouri,SEC,11,163,818,5.0,3,74.4,15,44,2.9,0,4.0,178,862,4.8,3,,nate-noel-1
81,Delbert Mimms,Eastern Michigan,MAC,12,184,805,4.4,9,67.1,19,145,7.6,1,12.1,203,950,4.7,10,,delbert-mimms-1
82,Diego Pavia*,Vanderbilt,SEC,13,192,801,4.2,8,61.6,0,0,,0,0.0,192,801,4.2,8,,diego-pavia-1
83,Kelley Joiner Jr.*,South Florida,American,13,121,799,6.6,12,61.5,8,51,6.4,2,3.9,129,850,6.6,14,,kelley-joiner-jr-1
84,Elijah Davis*,Louisiana,Sun Belt,14,163,796,4.9,9,56.9,11,86,7.8,1,6.1,174,882,5.1,10,,elijah-davis-5
85,Ja'Quinden Jackson*,Arkansas,SEC,10,149,790,5.3,15,79.0,13,139,10.7,0,13.9,162,929,5.7,15,,jaquinden-jackson-1
86,Marion Lukes,Central Michigan,MAC,11,161,788,4.9,5,71.6,16,160,10.0,1,14.5,177,948,5.4,6,,marion-lukes-1
87,Braydon Bennett*,Coastal Carolina,Sun Belt,11,134,781,5.8,11,71.0,25,188,7.5,2,17.1,159,969,6.1,13,,braydon-bennett-1
88,Dean Connors,Rice,American,12,159,780,4.9,9,65.0,62,485,7.8,2,40.4,221,1265,5.7,11,,dean-connors-1
89,Brendon Lewis,Nevada,MWC,12,157,775,4.9,8,64.6,1,18,18.0,0,1.5,158,793,5.0,8,,brendon-lewis-1
90,Le'Veon Moss*,Texas A&M,SEC,9,121,765,6.3,10,85.0,10,141,14.1,0,15.7,131,906,6.9,10,,leveon-moss-1
91,Davon Booth,Mississippi State,SEC,12,152,759,5.0,5,63.3,13,164,12.6,4,13.7,165,923,5.6,9,,davon-booth-1
92,Jevon Jackson,UTEP,CUSA,12,191,754,3.9,4,62.8,16,99,6.2,2,8.3,207,853,4.1,6,,jevon-jackson-1
93,Caden Durham*,LSU,SEC,12,140,753,5.4,6,62.8,28,260,9.3,2,21.7,168,1013,6.0,8,,caden-durham-1
94,Carson Hansen*,Iowa State,Big 12,14,151,752,5.0,13,53.7,13,88,6.8,2,6.3,164,840,5.1,15,,carson-hansen-1
95,Gavin Williams*,Northern Illinois,MAC,13,139,749,5.4,4,57.6,25,140,5.6,1,10.8,164,889,5.4,5,,gavin-williams-1
96,Jadarian Price*,Notre Dame,Ind,16,120,746,6.2,7,46.6,4,10,2.5,0,0.6,124,756,6.1,7,,jadarian-price-1
97,Justin Marshall*,Colorado State,MWC,13,154,746,4.8,4,57.4,8,62,7.8,0,4.8,162,808,5.0,4,,justin-marshall-2
98,Jevyon Ducker*,Sam Houston,CUSA,13,158,745,4.7,7,57.3,15,110,7.3,0,8.5,173,855,4.9,7,,jevyon-ducker-1
99,Quali Conley,Arizona,Big 12,12,150,745,5.0,8,62.1,39,245,6.3,1,20.4,189,990,5.2,9,,quali-conley-1
100,Jalen White*,Georgia Southern,Sun Belt,13,163,744,4.6,13,57.2,20,69,3.5,0,5.3,183,813,4.4,13,,jalen-white-1
101,Kye Robichaux*,Boston College,ACC,13,175,744,4.3,10,57.2,9,44,4.9,1,3.4,184,788,4.3,11,,kye-robichaux-1
102,Wayshawn Parker*,Washington State,Ind,12,137,735,5.4,4,61.3,11,108,9.8,1,9.0,148,843,5.7,5,,wayshawn-parker-1
103,CJ Donaldson*,West Virginia,Big 12,13,163,734,4.5,11,56.5,14,104,7.4,1,8.0,177,838,4.7,12,,cj-donaldson-1
104,Garrett Greene*,West Virginia,Big 12,11,134,734,5.5,6,66.7,0,0,,0,0.0,134,734,5.5,6,,garrett-greene-1
105,Durell Robinson*,Connecticut,Ind,12,107,731,6.8,8,60.9,14,75,5.4,0,6.3,121,806,6.7,8,,durell-robinson-2
106,Jaydon Blue*,Texas,SEC,15,134,730,5.4,8,48.7,42,368,8.8,6,24.5,176,1098,6.2,14,,jaydon-blue-1
107,Jalen Milroe*,Alabama,SEC,13,168,726,4.3,20,55.8,0,0,,0,0.0,168,726,4.3,20,,jalen-milroe-1
108,Mike Washington,New Mexico State,CUSA,12,157,725,4.6,8,60.4,9,74,8.2,1,6.2,166,799,4.8,9,,mike-washington-5
109,Floyd Chalk*,San Jose State,MWC,13,154,721,4.7,10,55.5,7,57,8.1,0,4.4,161,778,4.8,10,,floyd-chalk-1
110,Zak Wallace*,Arkansas State,Sun Belt,13,154,721,4.7,11,55.5,14,96,6.9,0,7.4,168,817,4.9,11,,zak-wallace-1
111,Billy Lucas*,Liberty,CUSA,11,123,720,5.9,5,65.5,5,51,10.2,0,4.6,128,771,6.0,5,,billy-lucas-1
112,LJ Martin*,BYU,Big 12,10,137,718,5.2,7,71.8,10,98,9.8,2,9.8,147,816,5.6,9,,lj-martin-1
113,Ahmani Marshall,Appalachian State,Sun Belt,11,149,713,4.8,7,64.8,11,71,6.5,0,6.5,160,784,4.9,7,,ahmani-marshall-1
114,Robert Henry*,UTSA,American,11,130,706,5.4,7,64.2,21,199,9.5,1,18.1,151,905,6.0,8,,robert-henry-1
115,Zylan Perry*,Louisiana,Sun Belt,13,112,695,6.2,4,53.5,11,46,4.2,0,3.5,123,741,6.0,4,,zylan-perry-1
116,Devin Mockobee,Purdue,Big Ten,12,138,687,5.0,4,57.3,17,170,10.0,1,14.2,155,857,5.5,5,,devin-mockobee-1
117,Savion Red,Nevada,MWC,12,119,687,5.8,8,57.3,16,74,4.6,0,6.2,135,761,5.6,8,,savion-red-1
118,Jalen Buckley*,Western Michigan,MAC,10,128,683,5.3,9,68.3,15,112,7.5,0,11.2,143,795,5.6,9,,jalen-buckley-1
119,Henry Parrish Jr.*,Ole Miss,SEC,9,130,678,5.2,10,75.3,15,82,5.5,0,9.1,145,760,5.2,10,,henry-parrish-jr-1
120,LaNorris Sellers*,South Carolina,SEC,12,166,674,4.1,7,56.2,0,0,,0,0.0,166,674,4.1,7,,lanorris-sellers-1
121,Jadan Baugh*,Florida,SEC,13,133,673,5.1,7,51.8,4,33,8.3,1,2.5,137,706,5.2,8,,jadan-baugh-1
122,Jayden Brown*,Connecticut,Ind,13,118,673,5.7,2,51.8,8,85,10.6,1,6.5,126,758,6.0,3,,jayden-brown-1
123,Dawson Pendergrass*,Baylor,Big 12,13,121,671,5.5,6,51.6,11,103,9.4,1,7.9,132,774,5.9,7,,dawson-pendergrass-1
124,Nate Frazier,Georgia,SEC,13,133,671,5.0,8,51.6,12,85,7.1,0,6.5,145,756,5.2,8,,nate-frazier-2
125,Ashton Daniels,Stanford,ACC,11,148,669,4.5,3,60.8,0,0,,0,0.0,148,669,4.5,3,,ashton-daniels-1
126,Jamarion Miller*,Alabama,SEC,13,145,668,4.6,7,51.4,16,155,9.7,1,11.9,161,823,5.1,8,,jamarion-miller-1
127,Ty Son Lawton,Indiana,Big Ten,13,141,668,4.7,12,51.4,12,124,10.3,0,9.5,153,792,5.2,12,,ty-son-lawton-2
128,Jordon Simmons,Akron,MAC,11,110,664,6.0,2,60.4,21,183,8.7,0,16.6,131,847,6.5,2,,jordon-simmons-1
129,Amari Daniels*,Texas A&M,SEC,12,139,661,4.8,8,55.1,7,60,8.6,0,5.0,146,721,4.9,8,,amari-daniels-1
130,Kylin James*,Nevada-Las Vegas,MWC,14,89,653,7.3,5,46.6,1,1,1.0,0,0.1,90,654,7.3,5,,kylin-james-1
131,Kay'ron Adams,Michigan State,Big Ten,12,133,649,4.9,2,54.1,15,85,5.7,0,7.1,148,734,5.0,2,,kayron-adams-1
132,Shane Porter*,North Texas,American,13,97,648,6.7,5,49.8,16,91,5.7,0,7.0,113,739,6.5,5,,shane-porter-1
133,Colton Joseph,Old Dominion,Sun Belt,9,114,647,5.7,11,71.9,0,0,,0,0.0,114,647,5.7,11,,colton-joseph-1
134,Hunter Watson*,Sam Houston,CUSA,12,168,647,3.9,9,53.9,0,0,,0,0.0,168,647,3.9,9,,hunter-watson-1
135,Ja'Quez Cross*,Arkansas State,Sun Belt,13,115,638,5.5,2,49.1,35,228,6.5,1,17.5,150,866,5.8,3,,jaquez-cross-1
136,Jaivian Thomas*,California,ACC,12,100,626,6.3,7,52.2,11,91,8.3,0,7.6,111,717,6.5,7,,jaivian-thomas-1
137,Dante Dowdell*,Nebraska,Big Ten,12,143,614,4.3,12,51.2,7,21,3.0,0,1.8,150,635,4.2,12,,dante-dowdell-1
138,Braylon Braxton,Marshall,Sun Belt,11,134,610,4.6,4,55.5,0,0,,0,0.0,134,610,4.6,4,,braylon-braxton-1
139,Josh McCray*,Illinois,Big Ten,13,117,609,5.2,10,46.8,13,116,8.9,1,8.9,130,725,5.6,11,,josh-mccray-1
140,Trevor Etienne,Georgia,SEC,10,122,609,5.0,9,60.9,32,194,6.1,0,19.4,154,803,5.2,9,,trevor-etienne-1
141,Mark Fletcher Jr.*,Miami (FL),ACC,13,112,607,5.4,9,46.7,10,106,10.6,0,8.2,122,713,5.8,9,,mark-fletcher-jr-1
142,Roman Hemby,Maryland,Big Ten,12,134,607,4.5,6,50.6,40,273,6.8,1,22.8,174,880,5.1,7,,roman-hemby-1
143,Avery Johnson*,Kansas State,Big 12,13,113,605,5.4,7,46.5,0,0,,0,0.0,113,605,5.4,7,,avery-johnson-2
144,Rodrigues Clark,Southern Mississippi,Sun Belt,12,124,604,4.9,1,50.3,13,51,3.9,0,4.3,137,655,4.8,1,,rodrigues-clark-1
145,Taylen Green*,Arkansas,SEC,13,156,602,3.9,8,46.3,0,0,,0,0.0,156,602,3.9,8,,taylen-green-1
146,Dylan Carson,Air Force,MWC,10,138,600,4.3,5,60.0,0,0,,0,0.0,138,600,4.3,5,,dylan-carson-1
147,Zahir Abdus-Salaam*,Western Michigan,MAC,13,113,600,5.3,3,46.2,31,250,8.1,1,19.2,144,850,5.9,4,,zahir-abdus-salaam-1
148,Emmett Johnson*,Nebraska,Big Ten,13,117,598,5.1,1,46.0,39,286,7.3,2,22.0,156,884,5.7,3,,emmett-johnson-2
149,Braedon Sloan,Ball State,MAC,12,150,597,4.0,4,49.8,29,329,11.3,1,27.4,179,926,5.2,5,,braedon-sloan-1
150,Duke Watson*,Louisville,ACC,12,67,597,8.9,7,49.8,5,60,12.0,1,5.0,72,657,9.1,8,,duke-watson-1
151,Marcus Carroll*,Missouri,SEC,13,140,595,4.3,12,45.8,9,66,7.3,0,5.1,149,661,4.4,12,,marcus-carroll-1
152,Montrell Johnson*,Florida,SEC,10,100,593,5.9,6,59.3,13,64,4.9,0,6.4,113,657,5.8,6,,montrell-johnson-1
153,Jordan Houston,Marshall,Sun Belt,13,111,592,5.3,2,45.5,13,173,13.3,1,13.3,124,765,6.2,3,,jordan-houston-1
154,Jamarion Wilcox,Kentucky,SEC,12,92,590,6.4,2,49.2,7,24,3.4,0,2.0,99,614,6.2,2,,jamarion-wilcox-1
155,Aidan Laughery*,Illinois,Big Ten,12,97,589,6.1,4,49.1,9,32,3.6,0,2.7,106,621,5.9,4,,aidan-laughery-1
156,Donovan Edwards*,Michigan,Big Ten,12,128,589,4.6,4,49.1,18,83,4.6,1,6.9,146,672,4.6,5,,donovan-edwards-1
157,Abu Sama*,Iowa State,Big 12,14,124,587,4.7,2,41.9,8,58,7.3,0,4.1,132,645,4.9,2,,abu-sama-1
158,Haynes King*,Georgia Tech,ACC,11,125,587,4.7,11,53.4,0,0,,0,0.0,125,587,4.7,11,,haynes-king-1
159,Demie Sumo,Kentucky,SEC,11,129,586,4.5,5,53.3,20,154,7.7,0,14.0,149,740,5.0,5,,demie-sumo-1
160,Sedrick Alexander*,Vanderbilt,SEC,13,164,586,3.6,6,45.1,23,238,10.3,1,18.3,187,824,4.4,7,,sedrick-alexander-1
161,Jalen John,Massachusetts,Ind,10,111,583,5.3,5,58.3,17,119,7.0,0,11.9,128,702,5.5,5,,jalen-john-6
162,Kaidon Salter*,Liberty,CUSA,11,114,579,5.1,7,52.6,0,0,,0,0.0,114,579,5.1,7,,kaidon-salter-1
163,Jovantae Barnes*,Oklahoma,SEC,9,122,577,4.7,5,64.1,17,123,7.2,1,13.7,139,700,5.0,6,,jovantae-barnes-1
164,Alex Tecza*,Navy,American,13,125,576,4.6,8,44.3,12,229,19.1,2,17.6,137,805,5.9,10,,alex-tecza-1
165,Daylan Smothers*,North Carolina State,ACC,11,89,571,6.4,6,51.9,19,263,13.8,2,23.9,108,834,7.7,8,,daylan-smothers-1
166,Noah Short*,Army,American,14,75,569,7.6,2,40.6,17,318,18.7,3,22.7,92,887,9.6,5,,noah-short-1
167,Antario Brown*,Northern Illinois,MAC,8,115,567,4.9,4,70.9,8,204,25.5,1,25.5,123,771,6.3,5,,antario-brown-1
168,Hashaun Wilson,Charlotte,American,12,91,559,6.1,7,46.6,4,42,10.5,0,3.5,95,601,6.3,7,,hashaun-wilson-1
169,Lincoln Pare*,Texas State,Sun Belt,13,95,554,5.8,8,42.6,12,134,11.2,0,10.3,107,688,6.4,8,,lincoln-pare-1
170,Ky Thomas,Kent State,MAC,11,135,549,4.1,1,49.9,10,53,5.3,0,4.8,145,602,4.2,1,,ky-thomas-1
171,Dylan Edwards*,Kansas State,Big 12,12,74,546,7.4,5,45.5,19,133,7.0,2,11.1,93,679,7.3,7,,dylan-edwards-1
172,Gerald Green,Troy,Sun Belt,12,111,545,4.9,3,45.4,9,134,14.9,1,11.2,120,679,5.7,4,,gerald-green-5
173,Marcel Reed*,Texas A&M,SEC,11,116,543,4.7,7,49.4,0,4,,0,0.4,116,547,4.7,7,,marcel-reed-1
174,Michael Benefield,Kennesaw State,CUSA,12,138,542,3.9,5,45.2,5,15,3.0,0,1.3,143,557,3.9,5,,michael-benefield-2
175,Johnnie Daniels,Mississippi State,SEC,12,108,540,5.0,4,45.0,8,76,9.5,0,6.3,116,616,5.3,4,,johnnie-daniels-1
176,Noah Whittington,Oregon,Big Ten,14,118,540,4.6,6,38.6,24,136,5.7,2,9.7,142,676,4.8,8,,noah-whittington-1
177,Christian Washington*,Coastal Carolina,Sun Belt,11,102,537,5.3,5,48.8,4,36,9.0,0,3.3,106,573,5.4,5,,christian-washington-1
178,Bryson Barnes,Utah State,MWC,9,68,530,7.8,5,58.9,0,0,,0,0.0,68,530,7.8,5,,bryson-barnes-1
179,CJ Hester,Massachusetts,Ind,11,119,529,4.4,4,48.1,14,58,4.1,0,5.3,133,587,4.4,4,,cj-hester-1
180,Omiri Wiggins*,Louisiana Tech,CUSA,13,111,527,4.7,4,40.5,20,126,6.3,2,9.7,131,653,5.0,6,,omiri-wiggins-1
181,Cartevious Norton,Charlotte,American,12,129,525,4.1,7,43.8,2,13,6.5,0,1.1,131,538,4.1,7,,cartevious-norton-1
182,Nay'quan Wright*,South Florida,American,13,109,510,4.7,8,39.2,22,149,6.8,0,11.5,131,659,5.0,8,,nayquan-wright-1
183,Jakobi Jackson*,Florida,SEC,13,95,509,5.4,7,39.2,7,76,10.9,0,5.8,102,585,5.7,7,,jakobi-jackson-1
184,TJ Harden,UCLA,Big Ten,12,124,506,4.1,2,42.2,40,368,9.2,1,30.7,164,874,5.3,3,,tj-harden-1
185,Cam Porter,Northwestern,Big Ten,11,126,501,4.0,6,45.5,23,174,7.6,0,15.8,149,675,4.5,6,,cam-porter-1
186,Kobe Pace,Virginia,ACC,11,114,499,4.4,3,45.4,21,189,9.0,0,17.2,135,688,5.1,3,,kobe-pace-1
187,Nate Carter,Michigan State,Big Ten,12,116,499,4.3,5,41.6,18,173,9.6,2,14.4,134,672,5.0,7,,nate-carter-4
188,Brandon High*,UTSA,American,12,93,495,5.3,8,41.3,6,58,9.7,0,4.8,99,553,5.6,8,,brandon-high-1
189,Jaxson Dart*,Ole Miss,SEC,13,124,495,4.0,3,38.1,0,0,,0,0.0,124,495,4.0,3,,jaxson-dart-1
190,Xavier Brown,Virginia,ACC,11,80,488,6.1,1,44.4,9,127,14.1,2,11.5,89,615,6.9,3,,xavier-brown-1
191,Zuberi Mobley,Florida Atlantic,American,9,92,487,5.3,4,54.1,11,86,7.8,0,9.6,103,573,5.6,4,,zuberi-mobley-1
192,Josh Williams*,LSU,SEC,13,117,482,4.1,6,37.1,31,263,8.5,0,20.2,148,745,5.0,6,,josh-williams-10
193,DJ McKinney*,Sam Houston,CUSA,12,97,481,5.0,3,40.1,12,99,8.3,0,8.3,109,580,5.3,3,,dj-mckinney-2
194,Telly Johnson Jr.*,Northern Illinois,MAC,6,103,480,4.7,4,80.0,2,3,1.5,0,0.5,105,483,4.6,4,,telly-johnson-jr-1
195,Dre'lyn Washington*,Louisiana,Sun Belt,11,73,478,6.5,5,43.5,6,107,17.8,1,9.7,79,585,7.4,6,,drelyn-washington-1
196,Quinten Joyner*,USC,Big Ten,12,63,478,7.6,3,39.8,12,89,7.4,1,7.4,75,567,7.6,4,,quinten-joyner-1
197,Kamari Moulton*,Iowa,Big Ten,12,84,473,5.6,3,39.4,1,12,12.0,0,1.0,85,485,5.7,3,,kamari-moulton-1
198,Jaiden Credle,Middle Tennessee State,CUSA,12,109,471,4.3,4,39.3,27,125,4.6,0,10.4,136,596,4.4,4,,jaiden-credle-1
199,Jordan Waters*,North Carolina State,ACC,12,95,470,4.9,4,39.2,15,167,11.1,1,13.9,110,637,5.8,5,,jordan-waters-1
200,Makenzie McGill*,North Texas,American,13,78,470,6.0,10,36.2,11,103,9.4,0,7.9,89,573,6.4,10,,makenzie-mcgill-1
201,Elijah Gilliam*,Fresno State,MWC,13,121,466,3.9,8,35.8,32,203,6.3,0,15.6,153,669,4.4,8,,elijah-gilliam-1
202,Quentin Hayes,Air Force,MWC,10,126,466,3.7,7,46.6,1,29,29.0,0,2.9,127,495,3.9,7,,quentin-hayes-2
203,Cade Klubnik,Clemson,ACC,14,119,463,3.9,7,33.1,0,0,,0,0.0,119,463,3.9,7,,cade-klubnik-1
204,Gio Lopez*,South Alabama,Sun Belt,11,83,463,5.6,7,42.1,0,0,,0,0.0,83,463,5.6,7,,gio-lopez-1
205,Bryson Donelson*,Fresno State,MWC,12,77,462,6.0,3,38.5,21,94,4.5,1,7.8,98,556,5.7,4,,bryson-donelson-1
206,Cam Cook*,Texas Christian,Big 12,12,119,460,3.9,9,38.3,18,75,4.2,0,6.3,137,535,3.9,9,,cam-cook-1
207,Connor Walendzak*,Toledo,MAC,13,128,458,3.6,1,35.2,14,77,5.5,0,5.9,142,535,3.8,1,,connor-walendzak-1
208,Antwan Raymond*,Rutgers,Big Ten,10,100,457,4.6,8,45.7,3,44,14.7,0,4.4,103,501,4.9,8,,antwan-raymond-1
209,Lawrance Toafili,Florida State,ACC,12,109,456,4.2,3,38.0,25,215,8.6,0,17.9,134,671,5.0,3,,lawrance-toafili-1
210,DeSean Bishop,Tennessee,SEC,10,74,455,6.1,3,45.5,1,10,10.0,0,1.0,75,465,6.2,3,,desean-bishop-1
211,Jamious Griffin,Oregon State,Ind,5,73,450,6.2,4,90.0,5,26,5.2,0,5.2,78,476,6.1,4,,jamious-griffin-1
212,Wayne Knight*,James Madison,Sun Belt,13,77,449,5.8,2,34.5,15,137,9.1,2,10.5,92,586,6.4,4,,wayne-knight-1
213,Justice Haynes*,Alabama,SEC,12,79,448,5.7,7,37.3,17,99,5.8,0,8.3,96,547,5.7,7,,justice-haynes-1
214,Brendan Sorsby,Cincinnati,Big 12,12,105,447,4.3,9,37.3,0,0,,0,0.0,105,447,4.3,9,,brendan-sorsby-1
215,Ethan Vasko*,Coastal Carolina,Sun Belt,12,107,447,4.2,5,37.3,0,0,,0,0.0,107,447,4.2,5,,ethan-vasko-1
216,Eli Heidenreich*,Navy,American,13,65,444,6.8,3,34.2,39,671,17.2,6,51.6,104,1115,10.7,9,,eli-heidenreich-1
217,Jackson Arnold*,Oklahoma,SEC,10,150,444,3.0,3,44.4,2,16,8.0,1,1.6,152,460,3.0,4,,jackson-arnold-1
218,Re'Shaun Sanford II,Houston,Big 12,12,94,444,4.7,1,37.0,18,157,8.7,0,13.1,112,601,5.4,1,,reshaun-sanford-ii-1
219,Sam Leavitt,Arizona State,Big 12,13,110,443,4.0,5,34.1,0,0,,0,0.0,110,443,4.0,5,,sam-leavitt-1
220,Alonza Barnett III*,James Madison,Sun Belt,12,135,442,3.3,7,36.8,0,0,,0,0.0,135,442,3.3,7,,alonza-barnett-iii-1
221,Jalon Daniels,Kansas,Big 12,12,93,439,4.7,6,36.6,0,0,,0,0.0,93,439,4.7,6,,jalon-daniels-1
222,Sam Scott,Wyoming,MWC,10,92,435,4.7,3,43.5,12,74,6.2,1,7.4,104,509,4.9,4,,sam-scott-1
223,Jaison Patterson*,Bowling Green,MAC,13,99,426,4.3,5,32.8,12,105,8.8,1,8.1,111,531,4.8,6,,jaison-patterson-1
224,Kendrick Raphael*,North Carolina State,ACC,12,78,425,5.4,3,35.4,10,41,4.1,0,3.4,88,466,5.3,3,,kendrick-raphael-1
225,Terrez Worthy,Temple,American,12,79,425,5.4,4,35.4,16,65,4.1,0,5.4,95,490,5.2,4,,terrez-worthy-1
226,Taron Keith*,South Florida,American,13,78,419,5.4,8,32.2,13,157,12.1,0,12.1,91,576,6.3,8,,taron-keith-1
227,Ulysses Bentley IV*,Ole Miss,SEC,13,84,419,5.0,5,32.2,13,99,7.6,0,7.6,97,518,5.3,5,,ulysses-bentley-iv-1
228,BJ Harris,Central Michigan,MAC,12,91,418,4.6,3,34.8,11,93,8.5,0,7.8,102,511,5.0,3,,bj-harris-1
229,Evan Pryor,Cincinnati,Big 12,12,56,418,7.5,6,34.8,15,181,12.1,1,15.1,71,599,8.4,7,,evan-pryor-1
230,Jake Retzlaff*,BYU,Big 12,13,100,417,4.2,6,32.1,0,0,,0,0.0,100,417,4.2,6,,jake-retzlaff-1
231,Qua Ashley,Kennesaw State,CUSA,12,122,409,3.4,1,34.1,28,255,9.1,1,21.3,150,664,4.4,2,,qua-ashley-1
232,Treshaun Ward*,Boston College,ACC,11,77,406,5.3,2,36.9,15,268,17.9,4,24.4,92,674,7.3,6,,treshaun-ward-1
233,Herschel Turner Jr.,Utah State,MWC,12,79,405,5.1,4,33.8,12,71,5.9,0,5.9,91,476,5.2,4,,herschel-turner-jr-1
234,Anthony Watkins,Tulsa,American,11,87,402,4.6,4,36.5,13,142,10.9,1,12.9,100,544,5.4,5,,anthony-watkins-3
235,Arnold Barnes III*,Tulane,American,14,87,402,4.6,6,28.7,8,19,2.4,1,1.4,95,421,4.4,7,,arnold-barnes-iii-1
236,Jacurri Brown,UCF,Big 12,9,53,401,7.6,4,44.6,0,0,,0,0.0,53,401,7.6,4,,jacurri-brown-1
237,Jordan Lyle*,Miami (FL),ACC,12,54,400,7.4,4,33.3,4,19,4.8,0,1.6,58,419,7.2,4,,jordan-lyle-1
238,Rickey Hunt*,Ohio,MAC,13,76,393,5.2,2,30.2,6,23,3.8,0,1.8,82,416,5.1,2,,rickey-hunt-1
239,Kejon Owens,Florida International,CUSA,11,92,392,4.3,5,35.6,9,82,9.1,0,7.5,101,474,4.7,5,,kejon-owens-1
240,Jaylon Jackson*,Iowa State,Big 12,14,93,388,4.2,2,27.7,7,41,5.9,1,2.9,100,429,4.3,3,,jaylon-jackson-2
241,Zeon Chriss,Houston,Big 12,11,114,388,3.4,4,35.3,2,29,14.5,0,2.6,116,417,3.6,4,,zeon-chriss-1
242,Jaylen Raynor*,Arkansas State,Sun Belt,13,137,387,2.8,3,29.8,1,11,11.0,0,0.8,138,398,2.9,3,,jaylen--raynor-1
243,Kenyon Clay,Southern Mississippi,Sun Belt,12,84,387,4.6,7,32.3,21,225,10.7,1,18.8,105,612,5.8,8,,kenyon-clay-1
244,Jaydn Ott*,California,ACC,10,116,385,3.3,4,38.5,24,222,9.3,1,22.2,140,607,4.3,5,,jaydn-ott-1
245,Isaiah Augustave*,Colorado,Big 12,11,85,384,4.5,4,34.9,11,62,5.6,0,5.6,96,446,4.6,4,,isaiah-augustave-1
246,NaQuari Rogers,New Mexico,MWC,10,74,382,5.2,5,38.2,3,14,4.7,1,1.4,77,396,5.1,6,,naquari-rogers-1
247,Jerrick Gibson*,Texas,SEC,15,78,377,4.8,4,25.1,3,25,8.3,0,1.7,81,402,5.0,4,,jerrick-gibson-1
248,Daniel Hishaw Jr.,Kansas,Big 12,8,65,376,5.8,3,47.0,3,33,11.0,0,4.1,68,409,6.0,3,,daniel-hishaw-jr-1
249,Nolan Ray,Maryland,Big Ten,12,75,374,5.0,2,31.2,11,76,6.9,0,6.3,86,450,5.2,2,,nolan-ray-1
250,Reggie Love III,Purdue,Big Ten,11,83,372,4.5,2,33.8,7,21,3.0,0,1.9,90,393,4.4,2,,reggie-love-iii-1
251,Torrance Burgess Jr.*,Texas State,Sun Belt,12,60,367,6.1,2,30.6,10,111,11.1,0,9.3,70,478,6.8,2,,torrance-burgess-jr-1
252,Greg Burrell*,Nevada-Las Vegas,MWC,11,65,366,5.6,3,33.3,2,12,6.0,0,1.1,67,378,5.6,3,,greg-burrell-1
253,Cam Fancher,Florida Atlantic,American,9,99,365,3.7,3,40.6,0,0,,0,0.0,99,365,3.7,3,,cam-fancher-1
254,Michel Dukes,Georgia State,Sun Belt,12,63,365,5.8,2,30.4,43,354,8.2,3,29.5,106,719,6.8,5,,michel-dukes-1
255,Tucker Gleason*,Toledo,MAC,12,97,364,3.8,7,30.3,0,0,,0,0.0,97,364,3.8,7,,tucker-gleason-1
256,Jordan McDonald*,Boston College,ACC,9,53,361,6.8,3,40.1,5,29,5.8,0,3.2,58,390,6.7,3,,jordan-mcdonald-1
257,Hinckley Ropati*,BYU,Big 12,8,68,360,5.3,1,45.0,5,76,15.2,1,9.5,73,436,6.0,2,,hinckley-ropati-1
258,Kedrick Reescano,Arizona,Big 12,12,78,359,4.6,1,29.9,8,47,5.9,0,3.9,86,406,4.7,1,,kedrick-reescano-1
259,London Montgomery*,East Carolina,American,11,71,359,5.1,2,32.6,5,29,5.8,0,2.6,76,388,5.1,2,,london-montgomery-1
260,Nico Iamaleava,Tennessee,SEC,13,109,358,3.3,3,27.5,0,0,,0,0.0,109,358,3.3,3,,nico-iamaleava-1
261,Braylen Russell*,Arkansas,SEC,10,67,354,5.3,3,35.4,3,18,6.0,0,1.8,70,372,5.3,3,,braylen-russell-1
262,Kevin Jennings,SMU,ACC,14,101,354,3.5,5,25.3,0,0,,0,0.0,101,354,3.5,5,,kevin-jennings-2
263,Viron Ellison Jr.,Tulsa,American,11,62,353,5.7,1,32.1,14,90,6.4,1,8.2,76,443,5.8,2,,viron-ellison-jr-1
264,Charles Kellom,Akron,MAC,12,85,352,4.1,1,29.3,27,210,7.8,2,17.5,112,562,5.0,3,,charles-kellom-1
265,Marcus Major*,Minnesota,Big Ten,12,78,352,4.5,3,29.3,20,144,7.2,1,12.0,98,496,5.1,4,,marcus-major-1
266,Kyson Brown,Arizona State,Big 12,14,73,351,4.8,2,25.1,13,189,14.5,1,13.5,86,540,6.3,3,,kyson-brown-1
267,Landon Sims,Hawaii,MWC,12,71,351,4.9,1,29.3,13,153,11.8,0,12.8,84,504,6.0,1,,landon-sims-1
268,CJ Ogbonna*,Buffalo,MAC,13,123,343,2.8,8,26.4,0,0,,0,0.0,123,343,2.8,8,,cj-ogbonna-1
269,Owen McCown*,UTSA,American,13,86,340,4.0,3,26.2,0,0,,0,0.0,86,340,4.0,3,,owen-mccown-1
270,Peyton Lewis,Tennessee,SEC,13,64,339,5.3,3,26.1,4,14,3.5,0,1.1,68,353,5.2,3,,peyton-lewis-1
271,Tate Carney,Wake Forest,ACC,12,83,339,4.1,6,28.3,9,113,12.6,1,9.4,92,452,4.9,7,,tate-carney-1
272,James Jones,Louisiana-Monroe,Sun Belt,10,78,336,4.3,1,33.6,4,80,20.0,2,8.0,82,416,5.1,3,,james-jones-17
273,Kyron Drones*,Virginia Tech,ACC,9,98,336,3.4,6,37.3,2,-2,-1.0,1,-0.2,100,334,3.3,7,,kyron-drones-1
274,Brandon Thomas*,Memphis,American,11,57,335,5.9,9,30.5,6,30,5.0,0,2.7,63,365,5.8,9,,brandon-thomas-5
275,Owen Allen,Air Force,MWC,10,77,335,4.4,2,33.5,0,0,,0,0.0,77,335,4.4,2,,owen-allen-1
276,Rashod Dubinion*,Arkansas,SEC,8,56,335,6.0,2,41.9,16,122,7.6,0,15.3,72,457,6.3,2,,rashod-dubinion-1
277,Kanye Roberts,Appalachian State,Sun Belt,8,82,332,4.0,1,41.5,8,80,10.0,1,10.0,90,412,4.6,2,,kanye-roberts-1
278,Kevin Davis*,Miami (OH),MAC,14,50,331,6.6,4,23.6,29,234,8.1,2,16.7,79,565,7.2,6,,kevin-davis-8
279,Eli Holstein*,Pitt,ACC,10,81,328,4.0,3,32.8,0,0,,0,0.0,81,328,4.0,3,,eli-holstein-1
280,Gevani McCoy,Oregon State,Ind,10,59,328,5.6,5,32.8,0,0,,0,0.0,59,328,5.6,5,,gevani-mccoy-1
281,Davion Gause*,North Carolina,ACC,13,67,326,4.9,4,25.1,4,45,11.3,0,3.5,71,371,5.2,4,,davion-gause-1
282,Cole Snyder,Eastern Michigan,MAC,12,136,323,2.4,4,26.9,0,0,,0,0.0,136,323,2.4,4,,cole-snyder-2
283,Ethan Payne,Marshall,Sun Belt,13,65,323,5.0,7,24.8,8,25,3.1,0,1.9,73,348,4.8,7,,ethan-payne-1
284,Harrison Waylee,Wyoming,MWC,4,63,323,5.1,1,80.8,2,5,2.5,0,1.3,65,328,5.0,1,,harrison-waylee-1
285,Savion Williams*,Texas Christian,Big 12,12,51,322,6.3,6,26.8,60,611,10.2,6,50.9,111,933,8.4,12,,savion-williams-2
286,Amani Givins*,Louisiana Tech,CUSA,9,75,319,4.3,2,35.4,6,38,6.3,0,4.2,81,357,4.4,2,,amani-givins-1
287,Bill Jackson,Tulsa,American,10,67,319,4.8,0,31.9,19,104,5.5,2,10.4,86,423,4.9,2,,bill-jackson-4
288,Jamari Ferrell,Wyoming,MWC,12,80,318,4.0,1,26.5,8,44,5.5,0,3.7,88,362,4.1,1,,jamari-ferrell-1
289,Rocco Becht*,Iowa State,Big 12,14,98,318,3.2,8,22.7,0,0,,0,0.0,98,318,3.2,8,,rocco-becht-1
290,Darrion Dupree,Wisconsin,Big Ten,11,79,317,4.0,1,28.8,12,119,9.9,0,10.8,91,436,4.8,1,,darrion-dupree-1
291,Peyton Jones*,Duke,ACC,13,82,317,3.9,3,24.4,8,94,11.8,1,7.2,90,411,4.6,4,,peyton-jones-3
292,Taisun Phommachanh,Massachusetts,Ind,9,107,317,3.0,3,35.2,0,0,,0,0.0,107,317,3.0,3,,taisun-phommachanh-1
293,OJ Arnold*,Georgia Southern,Sun Belt,12,63,316,5.0,4,26.3,24,145,6.0,2,12.1,87,461,5.3,6,,oj-arnold-1
294,Jaziun Patterson*,Iowa,Big Ten,10,63,309,4.9,2,30.9,1,3,3.0,0,0.3,64,312,4.9,2,,jaziun-patterson-1
295,Micah Ford,Stanford,ACC,9,76,309,4.1,0,34.3,15,84,5.6,0,9.3,91,393,4.3,0,,micah-ford-1
296,Lexington Joseph,Florida International,CUSA,12,82,308,3.8,3,25.7,10,41,4.1,0,3.4,92,349,3.8,3,,lexington-joseph-1
297,Stacy Sneed,Houston,Big 12,11,60,308,5.1,1,28.0,16,99,6.2,1,9.0,76,407,5.4,2,,stacy-sneed-1
298,Jacqez Barksdale*,Buffalo,MAC,12,82,306,3.7,2,25.5,5,26,5.2,0,2.2,87,332,3.8,2,,jacqez-barksdale-1
299,Kaden Feagin*,Illinois,Big Ten,5,67,306,4.6,3,61.2,5,37,7.4,0,7.4,72,343,4.8,3,,kaden-feagin-1
300,Antwaine Littleton,Temple,American,11,93,305,3.3,1,27.7,16,134,8.4,1,12.2,109,439,4.0,2,,antwaine-littleton-1
301,LJ Johnson Jr.,SMU,ACC,13,74,303,4.1,5,23.3,11,80,7.3,0,6.2,85,383,4.5,5,,lj-johnson-jr-2
302,Drew Allar*,Penn State,Big Ten,16,96,302,3.1,6,18.9,0,-4,,0,-0.3,96,298,3.1,6,,drew-allar-1
303,Leo Pulalasi*,Washington State,Ind,13,65,302,4.6,2,23.2,8,54,6.8,0,4.2,73,356,4.9,2,,leo-pulalasi-1
304,Jordan Brunson*,Miami (OH),MAC,9,53,299,5.6,4,33.2,1,3,3.0,0,0.3,54,302,5.6,4,,jordan-brunson-2
305,Davis Bryson,Kennesaw State,CUSA,11,113,297,2.6,4,27.0,0,0,,0,0.0,113,297,2.6,4,,davis-bryson-1
306,Jay Haynes,Clemson,ACC,13,43,295,6.9,3,22.7,7,32,4.6,0,2.5,50,327,6.5,3,,jay-haynes-1
307,Oscar Adaway III*,South Carolina,SEC,13,77,295,3.8,3,22.7,15,145,9.7,0,11.2,92,440,4.8,3,,oscar-adaway-iii-1
308,Myles Montgomery,UCF,Big 12,10,51,293,5.7,3,29.3,3,66,22.0,1,6.6,54,359,6.6,4,,myles-montgomery-1
309,Myles Bailey,Central Michigan,MAC,11,51,292,5.7,3,26.5,11,62,5.6,0,5.6,62,354,5.7,3,,myles-bailey-1
310,Chris Davis Jr.,Stanford,ACC,11,54,288,5.3,0,26.2,3,11,3.7,0,1.0,57,299,5.2,0,,chris-davis-jr-3
311,Devonte Lyons,Florida International,CUSA,4,43,288,6.7,2,72.0,4,26,6.5,0,6.5,47,314,6.7,2,,devonte-lyons-1
312,Bryce Duke,Old Dominion,Sun Belt,10,46,285,6.2,0,28.5,9,58,6.4,1,5.8,55,343,6.2,1,,bryce-duke-1
313,Payton Thorne,Auburn,SEC,11,112,283,2.5,2,25.7,0,0,,0,0.0,112,283,2.5,2,,payton-thorne-1
314,Demond Williams Jr.*,Washington,Big Ten,13,83,282,3.4,2,21.7,1,3,3.0,0,0.2,84,285,3.4,2,,demond-williams-jr-1
315,Chad Alexander*,Georgia Tech,ACC,10,58,280,4.8,1,28.0,5,22,4.4,0,2.2,63,302,4.8,1,,chad-alexander-5
316,Cade Harris,Air Force,MWC,12,48,279,5.8,4,23.3,23,368,16.0,2,30.7,71,647,9.1,6,,cade-harris-1
317,CJ Bailey*,North Carolina State,ACC,12,99,279,2.8,5,23.3,1,-6,-6.0,0,-0.5,100,273,2.7,5,,cj-bailey-2
318,Jordan McCloud*,Texas State,Sun Belt,13,74,278,3.8,7,21.4,0,0,,0,0.0,74,278,3.8,7,,jordan-mccloud-1
319,Quinn Henicle,Old Dominion,Sun Belt,3,34,278,8.2,3,92.7,0,0,,0,0.0,34,278,8.2,3,,quinn-henicle-1
320,Taylor Tatum*,Oklahoma,SEC,11,56,278,5.0,3,25.3,5,41,8.2,1,3.7,61,319,5.2,4,,taylor-tatum-1
321,Turbo Richard*,Boston College,ACC,8,55,278,5.1,2,34.8,2,62,31.0,0,7.8,57,340,6.0,2,,turbo-richard-1
322,Anthony Colandrea,Virginia,ACC,11,128,277,2.2,2,25.2,1,27,27.0,0,2.5,129,304,2.4,2,,anthony-colandrea-1
323,Javen Jacobs,New Mexico,MWC,7,40,277,6.9,3,39.6,17,130,7.6,1,18.6,57,407,7.1,4,,javen-jacobs-1
324,Damari Alston,Auburn,SEC,12,52,276,5.3,3,23.0,6,53,8.8,0,4.4,58,329,5.7,3,,damari-alston-1
325,Vaughn Pemberton,Ball State,MAC,10,61,276,4.5,2,27.6,8,76,9.5,1,7.6,69,352,5.1,3,,vaughn-pemberton-1
326,Quinton Jackson,Rice,American,12,48,275,5.7,1,22.9,11,69,6.3,1,5.8,59,344,5.8,2,,quinton-jackson-1
327,Cade Yacamelli,Wisconsin,Big Ten,12,33,274,8.3,2,22.8,4,35,8.8,0,2.9,37,309,8.4,2,,cade-yacamelli-1
328,Devin Roche,Old Dominion,Sun Belt,10,43,274,6.4,2,27.4,7,52,7.4,1,5.2,50,326,6.5,3,,devin-roche-1
329,Jekail Middlebrook,Middle Tennessee State,CUSA,9,60,273,4.6,2,30.3,22,163,7.4,1,18.1,82,436,5.3,3,,jekail-middlebrook-1
330,Deion Hankins*,Texas State,Sun Belt,13,62,272,4.4,2,20.9,0,0,,0,0.0,62,272,4.4,2,,deion-hankins-1
331,Alex Orji*,Michigan,Big Ten,11,57,269,4.7,1,24.5,0,0,,0,0.0,57,269,4.7,1,,alex-orji-1
332,Byrum Brown*,South Florida,American,6,68,269,4.0,3,44.8,1,12,12.0,1,2.0,69,281,4.1,4,,byrum-brown-1
333,Jacquez Stuart*,Toledo,MAC,12,68,269,4.0,2,22.4,16,180,11.3,0,15.0,84,449,5.3,2,,jacquez-stuart-1
334,Jobi Malary*,James Madison,Sun Belt,13,45,269,6.0,2,20.7,1,6,6.0,0,0.5,46,275,6.0,2,,jobi-malary-1
335,Rahmir Johnson*,Nebraska,Big Ten,10,54,261,4.8,1,26.1,21,179,8.5,1,17.9,75,440,5.9,2,,rahmir-johnson-1
336,Xavier Terrell,Florida Atlantic,American,7,14,261,18.6,3,37.3,1,-5,-5.0,0,-0.7,15,256,17.1,3,,xavier-terrell-1
337,Kade Frew,Air Force,MWC,8,45,260,5.8,1,32.5,2,15,7.5,0,1.9,47,275,5.9,1,,kade-frew-1
338,Ty Thompson*,Tulane,American,12,49,260,5.3,6,21.7,0,0,,0,0.0,49,260,5.3,6,,ty-thompson-2
339,Brayden Schager,Hawaii,MWC,11,136,259,1.9,6,23.5,0,0,,0,0.0,136,259,1.9,6,,brayden-schager-1
340,Lloyd Avant,Tulsa,American,12,76,259,3.4,1,21.6,12,62,5.2,0,5.2,88,321,3.6,1,,lloyd-avant-1
341,Salahadin Allah,Oregon State,Ind,12,55,258,4.7,1,21.5,2,6,3.0,0,0.5,57,264,4.6,1,,salahadin-allah-1
342,Joseph Himon II,Northwestern,Big Ten,12,52,257,4.9,2,21.4,15,96,6.4,1,8.0,67,353,5.3,3,,joseph-himon-ii-1
343,Jabari Bates*,San Jose State,MWC,13,59,254,4.3,1,19.5,2,17,8.5,1,1.3,61,271,4.4,2,,jabari-bates-1
344,Matthew Sluka*,Nevada-Las Vegas,MWC,3,39,253,6.5,1,84.3,0,0,,0,0.0,39,253,6.5,1,,matthew-sluka-1
345,Athan Kaliakmanis*,Rutgers,Big Ten,13,92,251,2.7,3,19.3,0,0,,0,0.0,92,251,2.7,3,,athan-kaliakmanis-1
346,Daba Fofana*,Navy,American,13,59,251,4.3,2,19.3,1,3,3.0,0,0.2,60,254,4.2,2,,daba-fofana-1
347,Kaelon Black,Indiana,Big Ten,13,46,251,5.5,2,19.3,4,6,1.5,0,0.5,50,257,5.1,2,,kaelon-black-1
348,Brandon Chatman*,Navy,American,13,48,250,5.2,3,19.2,18,257,14.3,4,19.8,66,507,7.7,7,,brandon-chatman-1
349,Ezell Jolly,UTEP,CUSA,7,64,248,3.9,1,35.4,6,38,6.3,0,5.4,70,286,4.1,1,,ezell-jolly-1
350,Anderson Castle,Appalachian State,Sun Belt,10,50,246,4.9,1,24.6,13,88,6.8,0,8.8,63,334,5.3,1,,anderson-castle-1
351,Patrick Garwo,Nevada,MWC,9,55,246,4.5,5,27.3,11,48,4.4,0,5.3,66,294,4.5,5,,patrick-garwo-1
352,Nick Evers*,Connecticut,Ind,9,80,245,3.1,3,27.2,0,0,,0,0.0,80,245,3.1,3,,nick-evers-1
353,Keyjuan Brown*,Louisville,ACC,11,47,243,5.2,3,22.1,5,53,10.6,0,4.8,52,296,5.7,3,,keyjuan-brown-1
354,Beau Pribula*,Penn State,Big Ten,13,38,242,6.4,4,18.6,0,0,,0,0.0,38,242,6.4,4,,beau-pribula-1
355,Chandler Morris*,North Texas,American,12,60,242,4.0,4,20.2,0,0,,0,0.0,60,242,4.0,4,,chandler-morris-1
356,Terron Kellman,Charlotte,American,9,48,242,5.0,0,26.9,1,8,8.0,0,0.9,49,250,5.1,0,,terron-kellman-1
357,Richard Reese*,Baylor,Big 12,11,58,241,4.2,1,21.9,6,41,6.8,0,3.7,64,282,4.4,1,,richard-reese-1
358,Brandon Campbell,Massachusetts,Ind,11,64,239,3.7,3,21.7,8,67,8.4,0,6.1,72,306,4.3,3,,brandon-campbell-4
359,JC French*,Georgia Southern,Sun Belt,13,117,239,2.0,2,18.4,0,0,,0,0.0,117,239,2.0,2,,jc-french-1
360,Jeremy Payne*,Texas Christian,Big 12,13,54,239,4.4,3,18.4,12,99,8.3,0,7.6,66,338,5.1,3,,jeremy-payne-1
361,Evan Svoboda,Wyoming,MWC,12,109,237,2.2,5,19.8,0,0,,0,0.0,109,237,2.2,5,,evan-svoboda-1
362,Skyler Locklear,UTEP,CUSA,10,80,237,3.0,2,23.7,3,32,10.7,1,3.2,83,269,3.2,3,,skyler-locklear-1
363,J'Koby Williams*,Texas Tech,Big 12,10,41,236,5.8,2,23.6,10,100,10.0,1,10.0,51,336,6.6,3,,jkoby-williams-1
364,Xavier Robinson*,Oklahoma,SEC,7,49,233,4.8,4,33.3,13,119,9.2,0,17.0,62,352,5.7,4,,xavier-robinson-2
365,Chez Mellusi,Wisconsin,Big Ten,4,56,232,4.1,3,58.0,6,17,2.8,0,4.3,62,249,4.0,3,,chez-mellusi-1
366,Josh Holst*,Northern Illinois,MAC,7,49,230,4.7,1,32.9,0,0,,0,0.0,49,230,4.7,1,,josh-holst-1
367,Sawyer Robertson*,Baylor,Big 12,12,63,230,3.7,4,19.2,0,0,,0,0.0,63,230,3.7,4,,sawyer-robertson-1
368,Trent Howland,Oklahoma State,Big 12,10,41,230,5.6,1,23.0,3,7,2.3,0,0.7,44,237,5.4,1,,trent-howland-1
369,David Mbadinga*,Georgia Southern,Sun Belt,13,58,229,3.9,3,17.6,3,26,8.7,0,2.0,61,255,4.2,3,,david-mbadinga-1
370,Gregory Desrosiers*,Memphis,American,8,31,228,7.4,3,28.5,21,175,8.3,4,21.9,52,403,7.8,7,,gregory-desrosiers-1
371,Joe Jackson*,Kansas State,Big 12,10,39,227,5.8,1,22.7,6,63,10.5,1,6.3,45,290,6.4,2,,joe-jackson-4
372,Robby Ashford*,South Carolina,SEC,8,41,227,5.5,2,28.4,0,0,,0,0.0,41,227,5.5,2,,robby-ashford-1
373,Shaadie Clayton-Johnson*,Tulane,American,11,34,227,6.7,1,20.6,8,57,7.1,0,5.2,42,284,6.8,1,,shaadie-clayton-1
374,Matt Jones*,Ole Miss,SEC,7,44,226,5.1,3,32.3,3,13,4.3,0,1.9,47,239,5.1,3,,matt-jones-9
375,Will Howard*,Ohio State,Big Ten,16,105,226,2.2,7,14.1,1,0,0.0,0,0.0,106,226,2.1,7,,will-howard-2
376,Aidan Chiles,Michigan State,Big Ten,12,97,225,2.3,3,18.8,0,0,,0,0.0,97,225,2.3,3,,aidan-chiles-1
377,Cameron Dickey*,Texas Tech,Big 12,12,41,225,5.5,1,18.8,9,47,5.2,1,3.9,50,272,5.4,2,,cameron-dickey-1
378,Marlon Gunn Jr.*,East Carolina,American,12,61,224,3.7,3,18.7,2,34,17.0,0,2.8,63,258,4.1,3,,marlon-gunn-jr-1
379,Marquis Crosby*,Louisiana Tech,CUSA,11,57,224,3.9,1,20.4,2,5,2.5,0,0.5,59,229,3.9,1,,marquis-crosby-1
380,Brady Cook*,Missouri,SEC,12,87,223,2.6,5,18.6,0,0,,0,0.0,87,223,2.6,5,,brady-cook-1
381,Kevorian Barnes*,UTSA,American,12,78,221,2.8,2,18.4,7,61,8.7,0,5.1,85,282,3.3,2,,kevorian-barnes-1
382,Maddux Madsen,Boise State,MWC,14,57,221,3.9,5,15.8,0,0,,0,0.0,57,221,3.9,5,,maddux-madsen-1
383,Aneyas Williams*,Notre Dame,Ind,15,34,219,6.4,2,14.6,18,172,9.6,0,11.5,52,391,7.5,2,,aneyas-williams-1
384,Elijah Jackson-Anderson,Eastern Michigan,MAC,12,54,218,4.0,2,18.2,4,64,16.0,1,5.3,58,282,4.9,3,,elijah-jackson-anderson-1
385,Tyler Warren*,Penn State,Big Ten,16,26,218,8.4,4,13.6,104,1233,11.9,8,77.1,130,1451,11.2,12,H-7,tyler-warren-1
386,Luke Altmyer*,Illinois,Big Ten,13,99,217,2.2,4,16.7,1,3,3.0,0,0.2,100,220,2.2,4,,luke-altmyer-1
387,Jamal Roberts*,Missouri,SEC,13,53,216,4.1,3,16.6,5,21,4.2,0,1.6,58,237,4.1,3,,jamal-roberts-2
388,Sevaughn Clark*,Toledo,MAC,11,65,215,3.3,0,19.5,9,51,5.7,0,4.6,74,266,3.6,0,,sevaughn-clark-1
389,Terry Wilkins,Middle Tennessee State,CUSA,12,54,214,4.0,1,17.8,13,69,5.3,1,5.8,67,283,4.2,2,,terry-wilkins-1
390,Jack Lausch,Northwestern,Big Ten,10,87,213,2.4,2,21.3,0,0,,0,0.0,87,213,2.4,2,,jack-lausch-1
391,Ca'Lil Valentine*,Illinois,Big Ten,12,53,212,4.0,1,17.7,5,30,6.0,0,2.5,58,242,4.2,1,,calil-valentine-1
392,Daniel Carter*,Pitt,ACC,10,22,208,9.5,4,20.8,3,22,7.3,1,2.2,25,230,9.2,5,,daniel-carter-1
393,Peny Boone,UCF,Big 12,6,34,208,6.1,2,34.7,1,9,9.0,0,1.5,35,217,6.2,2,,peny-boone-1
394,E.J. Smith*,Texas A&M,SEC,12,54,207,3.8,0,17.3,8,66,8.3,0,5.5,62,273,4.4,0,,ej-smith-2
395,Ethan Crawford,Southern Mississippi,Sun Belt,8,97,207,2.1,3,25.9,0,0,,0,0.0,97,207,2.1,3,,ethan-crawford-2
396,Hayden Reed*,Army,American,14,40,207,5.2,1,14.8,6,63,10.5,1,4.5,46,270,5.9,2,,hayden-reed-1
397,Joey Aguilar,Appalachian State,Sun Belt,11,59,207,3.5,2,18.8,0,0,,0,0.0,59,207,3.5,2,,joey-aguilar-1
398,Stone Earle,Marshall,Sun Belt,9,57,207,3.6,0,23.0,0,0,,0,0.0,57,207,3.6,0,,stone-earle-1
399,Tyler Jefferson,Central Michigan,MAC,7,43,207,4.8,1,29.6,0,0,,0,0.0,43,207,4.8,1,,tyler-jefferson-1
400,Vaughn Blue*,Liberty,CUSA,12,35,207,5.9,1,17.3,7,43,6.1,0,3.6,42,250,6.0,1,,vaughn-blue-1
401,Devin Spencer*,Arkansas State,Sun Belt,8,40,206,5.2,0,25.8,3,14,4.7,0,1.8,43,220,5.1,0,,devin-spencer-1
402,George Hart III*,Western Kentucky,CUSA,14,43,206,4.8,2,14.7,7,34,4.9,0,2.4,50,240,4.8,2,,george-hart-iii-1
403,Kiefer Sibley*,North Texas,American,8,44,206,4.7,0,25.8,15,82,5.5,1,10.3,59,288,4.9,1,,kiefer-sibley-1
404,Cameron Ward*,Miami (FL),ACC,13,60,204,3.4,4,15.7,1,7,7.0,1,0.5,61,211,3.5,5,H-4AA,cameron-ward-1
405,Michael Hawkins Jr.*,Oklahoma,SEC,7,69,204,3.0,1,29.1,0,0,,0,0.0,69,204,3.0,1,,michael-hawkins-jr-1
406,Cooper Legas,Tulsa,American,11,79,201,2.5,1,18.3,0,0,,0,0.0,79,201,2.5,1,,cooper-legas-1
407,Elijah Green,Indiana,Big Ten,7,29,201,6.9,5,28.7,0,0,,0,0.0,29,201,6.9,5,,elijah-green-1
408,Samuel Brown V*,Rutgers,Big Ten,5,40,201,5.0,3,40.2,1,34,34.0,1,6.8,41,235,5.7,4,,samuel-brown-v-1
409,Domonique Thomas*,Ole Miss,SEC,13,42,197,4.7,1,15.2,0,0,,0,0.0,42,197,4.7,1,,domonique-thomas-1
410,James Peoples*,Ohio State,Big Ten,8,49,197,4.0,2,24.6,1,-2,-2.0,0,-0.3,50,195,3.9,2,,james-peoples-1
411,Dallan Hayden*,Colorado,Big 12,11,64,196,3.1,1,17.8,17,132,7.8,0,12.0,81,328,4.0,1,,dallan-hayden-1
412,Malik Sherrod*,Fresno State,MWC,4,60,196,3.3,4,49.0,8,38,4.8,0,9.5,68,234,3.4,4,,malik-sherrod-1
413,Jase Bauer*,Sam Houston,CUSA,7,45,195,4.3,0,27.9,1,1,1.0,0,0.1,46,196,4.3,0,,jase-bauer-1
414,Thomas Castellanos*,Boston College,ACC,8,93,194,2.1,1,24.3,0,0,,0,0.0,93,194,2.1,1,,thomas-castellanos-1
415,Adam Mohammed*,Washington,Big Ten,13,42,193,4.6,0,14.8,6,41,6.8,0,3.2,48,234,4.9,0,,adam-mohammed-1
416,Damashja Harris*,North Texas,American,3,22,193,8.8,1,64.3,4,7,1.8,0,2.3,26,200,7.7,1,,damashja-harris-1
417,K.J. Jefferson,UCF,Big 12,5,61,193,3.2,2,38.6,0,0,,0,0.0,61,193,3.2,2,,kj-jefferson-1
418,Cameron Davis*,Washington,Big Ten,12,44,190,4.3,0,15.8,14,156,11.1,0,13.0,58,346,6.0,0,,cameron-davis-3
419,Jaylen Poe*,Northern Illinois,MAC,8,36,190,5.3,3,23.8,4,22,5.5,0,2.8,40,212,5.3,3,,jaylen-poe-1
420,Seth Henigan*,Memphis,American,13,80,190,2.4,1,14.6,0,0,,0,0.0,80,190,2.4,1,,seth-henigan-1
421,Willie Shaw III*,Toledo,MAC,6,46,190,4.1,3,31.7,2,22,11.0,0,3.7,48,212,4.4,3,,willie-shaw-iii-1
422,Bryan Jackson*,USC,Big Ten,13,36,188,5.2,1,14.5,1,0,0.0,0,0.0,37,188,5.1,1,,bryan-jackson-3
423,Jamal Johnson*,Bowling Green,MAC,13,26,188,7.2,1,14.5,31,231,7.5,1,17.8,57,419,7.4,2,,jamal-johnson-2
424,Micah Welch*,Colorado,Big 12,9,43,186,4.3,4,20.7,8,54,6.8,0,6.0,51,240,4.7,4,,micah-welch-1
425,Trent Battle*,Texas Christian,Big 12,8,44,186,4.2,2,23.3,6,29,4.8,0,3.6,50,215,4.3,2,,trent-battle-1
426,AJ Newberry*,Vanderbilt,SEC,11,41,185,4.5,3,16.8,7,134,19.1,2,12.2,48,319,6.6,5,,aj-newberry-1
427,Rodney Hill*,Arkansas,SEC,10,28,184,6.6,2,18.4,8,68,8.5,0,6.8,36,252,7.0,2,,rodney-hill-1
428,Ajay Allen*,Miami (FL),ACC,8,24,183,7.6,2,22.9,2,23,11.5,0,2.9,26,206,7.9,2,,ajay-allen-1
429,Gavin Wimsatt,Kentucky,SEC,8,49,183,3.7,2,22.9,0,0,,0,0.0,49,183,3.7,2,,gavin-wimsatt-1
430,Jimmy Holiday*,Louisiana Tech,CUSA,13,48,182,3.8,4,14.0,39,476,12.2,2,36.6,87,658,7.6,6,,jimmy-holiday-1
431,J'Marion Burnette,Houston,Big 12,8,43,182,4.2,0,22.8,1,7,7.0,0,0.9,44,189,4.3,0,,jmarion-burnette-1
432,Jeremiah Coney*,Virginia Tech,ACC,12,32,179,5.6,0,14.9,0,0,,0,0.0,32,179,5.6,0,,jeremiah-coney-1
433,Keegan Jones,UCLA,Big Ten,12,47,179,3.8,1,14.9,19,201,10.6,1,16.8,66,380,5.8,2,,keegan-jones-1
434,Trayvon Rudolph*,Northern Illinois,MAC,11,14,179,12.8,2,16.3,37,392,10.6,1,35.6,51,571,11.2,3,,trayvon-rudolph-1
435,Donald Chaney Jr.*,Louisville,ACC,11,50,178,3.6,3,16.2,7,62,8.9,0,5.6,57,240,4.2,3,,donald-chaney-jr-1
436,Jalen Berger,UCLA,Big Ten,8,48,178,3.7,0,22.3,10,59,5.9,2,7.4,58,237,4.1,2,,jalen-berger-1
437,Shomari Lawrence,Florida International,CUSA,8,47,177,3.8,1,22.1,1,1,1.0,0,0.1,48,178,3.7,1,,shomari-lawrence-1
438,Logan Smothers*,Jacksonville State,CUSA,7,22,175,8.0,3,25.0,0,0,,0,0.0,22,175,8.0,3,,logan-smothers-1
439,Ahmad Haston,Massachusetts,Ind,5,18,174,9.7,1,34.8,0,0,,0,0.0,18,174,9.7,1,,ahmad-haston-1
440,Ben Wooldridge*,Louisiana,Sun Belt,11,65,174,2.7,5,15.8,0,0,,0,0.0,65,174,2.7,5,,ben-wooldridge-1
441,Braxton Woodson*,Navy,American,10,49,173,3.5,3,17.3,0,0,,0,0.0,49,173,3.5,3,,braxton-woodson-1
442,Kam Davis,Florida State,ACC,9,52,173,3.3,0,19.2,2,21,10.5,0,2.3,54,194,3.6,0,,kam-davis-1
443,Bryson Donnell*,UTSA,American,12,35,172,4.9,0,14.3,4,5,1.3,0,0.4,39,177,4.5,0,,bryson-donnell-1
444,John Busha,Air Force,MWC,6,78,172,2.2,1,28.7,0,0,,0,0.0,78,172,2.2,1,,john-busha-1
445,Cam Pickett,Ball State,MAC,12,17,170,10.0,2,14.2,49,528,10.8,2,44.0,66,698,10.6,4,,cam-pickett-1
446,Katin Houser*,East Carolina,American,9,49,170,3.5,4,18.9,0,0,,0,0.0,49,170,3.5,4,,katin-houser-1
447,Andrew Paul*,Jacksonville State,CUSA,12,39,167,4.3,4,13.9,2,-1,-0.5,0,-0.1,41,166,4.0,4,,andrew-paul-1
448,Bishop Davenport*,South Alabama,Sun Belt,11,37,167,4.5,1,15.2,0,0,,0,0.0,37,167,4.5,1,,bishop-davenport-2
449,Lee Witherspoon,UAB,American,12,35,166,4.7,0,13.8,4,12,3.0,0,1.0,39,178,4.6,0,,lee-witherspoon-1
450,Malachi Thomas*,Virginia Tech,ACC,10,43,165,3.8,1,16.5,4,25,6.3,0,2.5,47,190,4.0,1,,malachi-thomas-1
451,Sean Dollars,Nevada,MWC,11,47,165,3.5,0,15.0,11,74,6.7,0,6.7,58,239,4.1,0,,sean-dollars-1
452,Brad Jackson*,Texas State,Sun Belt,3,22,164,7.5,4,54.7,0,0,,0,0.0,22,164,7.5,4,,brad-jackson-2
453,Sevion Morrison,Kansas,Big 12,10,27,164,6.1,2,16.4,1,18,18.0,0,1.8,28,182,6.5,2,,sevion-morrison-1
454,D.J. Jones,Wyoming,MWC,4,57,162,2.8,0,40.5,4,24,6.0,0,6.0,61,186,3.0,0,,dj-jones-6
455,Isaiah Jacobs,UAB,American,4,41,162,4.0,0,40.5,7,33,4.7,0,8.3,48,195,4.1,0,,isaiah-jacobs-1
456,Tylan Hines,Hawaii,MWC,12,39,162,4.2,0,13.5,23,186,8.1,3,15.5,62,348,5.6,3,,tylan-hines-1
457,Tyler Purdy*,James Madison,Sun Belt,8,36,161,4.5,2,20.1,6,44,7.3,0,5.5,42,205,4.9,2,,tyler-purdy-1
458,Roderick Daniels Jr.,SMU,ACC,14,44,160,3.6,3,11.4,42,663,15.8,4,47.4,86,823,9.6,7,,roderick-daniels-jr-1
459,Terrence Gist,Air Force,MWC,6,40,159,4.0,0,26.5,0,0,,0,0.0,40,159,4.0,0,,terrence-gist-2
460,Cam Barfield,Hawaii,MWC,10,33,158,4.8,0,15.8,7,55,7.9,0,5.5,40,213,5.3,0,,cam-barfield-1
461,Mike Mitchell,Utah,Big 12,11,47,158,3.4,1,14.4,1,5,5.0,0,0.5,48,163,3.4,1,,mike-mitchell-8
462,Taji Atkins,Rice,American,5,24,158,6.6,2,31.6,0,0,,0,0.0,24,158,6.6,2,,taji-atkins-1
463,Sire Gaines,Boise State,MWC,3,20,156,7.8,1,52.0,3,44,14.7,1,14.7,23,200,8.7,2,,sire-gaines-1
464,Ryan Browne,Purdue,Big Ten,8,50,155,3.1,0,19.4,0,0,,0,0.0,50,155,3.1,0,,ryan-browne-1
465,Jalen Dupree*,Colorado State,MWC,5,25,153,6.1,1,30.6,1,2,2.0,0,0.4,26,155,6.0,1,,jalen-dupree-1
466,Messiah Burch*,Buffalo,MAC,13,29,153,5.3,2,11.8,9,99,11.0,0,7.6,38,252,6.6,2,,messiah-burch-1
467,Taven Curry,Louisiana-Monroe,Sun Belt,11,32,153,4.8,0,13.9,3,22,7.3,0,2.0,35,175,5.0,0,,taven-curry-1
468,Corey Smith*,Penn State,Big Ten,4,22,152,6.9,0,38.0,1,-2,-2.0,0,-0.5,23,150,6.5,0,,corey-smith-8
469,Dylan Downing*,Miami (OH),MAC,10,44,152,3.5,1,15.2,6,24,4.0,0,2.4,50,176,3.5,1,,dylan-downing-2
470,Brendan Sullivan*,Iowa,Big Ten,10,47,150,3.2,4,15.0,0,0,,0,0.0,47,150,3.2,4,,brendan-sullivan-1
471,Caden Veltkamp*,Western Kentucky,CUSA,13,113,150,1.3,7,11.5,0,0,,0,0.0,113,150,1.3,7,,caden-veltkamp-1
472,Colby McDonald,Maryland,Big Ten,7,29,150,5.2,0,21.4,2,16,8.0,0,2.3,31,166,5.4,0,,colby-mcdonald-1
473,Kaleb Jackson*,LSU,SEC,13,44,150,3.4,0,11.5,6,46,7.7,0,3.5,50,196,3.9,0,,kaleb-jackson-1
474,Lamar Sperling*,Buffalo,MAC,12,39,150,3.8,1,12.5,5,59,11.8,1,4.9,44,209,4.8,2,,lamar-sperling-1
475,Dillon Gabriel,Oregon,Big Ten,14,75,149,2.0,7,10.6,0,0,,0,0.0,75,149,2.0,7,H-3,dillon-gabriel-1
476,Djouvensky Schlenbaker*,Washington State,Ind,11,43,149,3.5,3,13.5,3,15,5.0,0,1.4,46,164,3.6,3,,djouvensky-schlenbaker-1
477,Nick Poulos*,Ohio,MAC,8,28,149,5.3,1,18.6,0,0,,0,0.0,28,149,5.3,1,,nick-poulos-1
478,Trey Cornist*,Tulane,American,6,22,149,6.8,1,24.8,2,21,10.5,0,3.5,24,170,7.1,1,,trey-cornist-1
479,Billy Edwards Jr.,Maryland,Big Ten,11,81,148,1.8,5,13.5,0,-12,,0,-1.1,81,136,1.7,5,,billy-edwards-jr-1
480,DeCarlos Brooks,Arizona State,Big 12,12,37,148,4.0,1,12.3,1,7,7.0,0,0.6,38,155,4.1,1,,decarlos-brooks-1
481,Maquel Haywood,Appalachian State,Sun Belt,8,29,148,5.1,1,18.5,5,52,10.4,0,6.5,34,200,5.9,1,,maquel-haywood-1
482,Donovan Smith,Houston,Big 12,9,65,147,2.3,3,16.3,0,0,,0,0.0,65,147,2.3,3,,donovan-smith-2
483,Richard Young*,Alabama,SEC,7,27,146,5.4,2,20.9,1,7,7.0,0,1.0,28,153,5.5,2,,richard-young-2
484,Curtis Douglas,Kent State,MAC,9,48,145,3.0,0,16.1,4,2,0.5,0,0.2,52,147,2.8,0,,curtis-douglas-1
485,Sione I Moa*,BYU,Big 12,11,29,144,5.0,3,13.1,5,38,7.6,0,3.5,34,182,5.4,3,,sione-moa-2
486,Collin Schlee*,Virginia Tech,ACC,9,41,143,3.5,2,15.9,0,0,,0,0.0,41,143,3.5,2,,collin-schlee-1
487,Jeremiah Cobb,Auburn,SEC,12,29,142,4.9,0,11.8,6,45,7.5,0,3.8,35,187,5.3,0,,jeremiah-cobb-1
488,Tahj Bullock,Akron,MAC,12,54,142,2.6,8,11.8,10,63,6.3,0,5.3,64,205,3.2,8,,tahj-bullock-1
489,Lamar Radcliffe*,San Jose State,MWC,7,33,141,4.3,1,20.1,0,0,,0,0.0,33,141,4.3,1,,lamar-radcliffe-1
490,Derrick Jameson,Utah State,MWC,4,15,140,9.3,2,35.0,0,0,,0,0.0,15,140,9.3,2,,derrick-jameson-1
491,Hank Bachmeier,Wake Forest,ACC,12,96,140,1.5,1,11.7,1,1,1.0,0,0.1,97,141,1.5,1,,hank-bachmeier-1
492,Keyvone Lee,Mississippi State,SEC,4,29,140,4.8,1,35.0,3,13,4.3,0,3.3,32,153,4.8,1,,keyvone-lee-1
493,Caleb Komolafe,Northwestern,Big Ten,10,50,139,2.8,0,13.9,2,8,4.0,0,0.8,52,147,2.8,0,,caleb-komolafe-1
494,Dewayne Coleman*,Army,American,7,38,136,3.6,1,19.4,0,0,,0,0.0,38,136,3.6,1,,dewayne-coleman-1
495,Ethan Garbers,UCLA,Big Ten,11,83,136,1.6,1,12.4,0,0,,0,0.0,83,136,1.6,1,,ethan-garbers-1
496,Maurice Turner*,Louisville,ACC,4,27,136,5.0,1,34.0,1,8,8.0,0,2.0,28,144,5.1,1,,maurice-turner-2
497,Nahree Biggins,Central Michigan,MAC,6,19,136,7.2,0,22.7,3,7,2.3,0,1.2,22,143,6.5,0,,nahree-biggins-1
498,Simeon Price*,Coastal Carolina,Sun Belt,9,44,136,3.1,0,15.1,2,7,3.5,0,0.8,46,143,3.1,0,,simeon-price-1
499,Dylan Riley,Boise State,MWC,11,22,135,6.1,2,12.3,3,22,7.3,0,2.0,25,157,6.3,2,,dylan-riley-1
500,Luke Grimm,Kansas,Big 12,12,11,135,12.3,1,11.3,51,690,13.5,6,57.5,62,825,13.3,7,,luke-grimm-1
501,Broc Lowry*,Western Michigan,MAC,11,25,133,5.3,3,12.1,0,0,,0,0.0,25,133,5.3,3,,broc-lowry-1
502,JP Pickles,UTEP,CUSA,3,39,133,3.4,1,44.3,0,0,,0,0.0,39,133,3.4,1,,jp-pickles-1
503,Darian Mensah*,Tulane,American,13,60,132,2.2,1,10.2,0,0,,0,0.0,60,132,2.2,1,,darian-mensah-1
504,Darren Lloyd*,Coastal Carolina,Sun Belt,11,21,132,6.3,0,12.0,1,0,0.0,0,0.0,22,132,6.0,0,,darren-lloyd-1
505,Joquez Smith,Temple,American,12,36,132,3.7,1,11.0,9,39,4.3,0,3.3,45,171,3.8,1,,joquez-smith-1
506,Sam Franklin*,Oklahoma,SEC,12,18,132,7.3,0,11.0,5,18,3.6,0,1.5,23,150,6.5,0,,sam-franklin-2
507,Brock Vandagriff,Kentucky,SEC,11,90,131,1.5,0,11.9,0,0,,0,0.0,90,131,1.5,0,,brock-vandagriff-1
508,Eric Singleton Jr.*,Georgia Tech,ACC,12,21,131,6.2,1,10.9,56,754,13.5,3,62.8,77,885,11.5,4,,eric-singleton-jr-1
509,Santino Marucci,New Mexico State,CUSA,7,37,131,3.5,1,18.7,0,0,,0,0.0,37,131,3.5,1,,santino-marucci-1
510,Cole Tabb,Stanford,ACC,3,27,130,4.8,0,43.3,2,9,4.5,0,3.0,29,139,4.8,0,,cole-tabb-1
511,Jacory Barney Jr.*,Nebraska,Big Ten,13,10,130,13.0,3,10.0,55,447,8.1,0,34.4,65,577,8.9,3,,jacory-barney-jr-1
512,Keyone Jenkins,Florida International,CUSA,12,75,130,1.7,2,10.8,0,0,,0,0.0,75,130,1.7,2,,keyone-jenkins-1
513,Yasin Willis*,Syracuse,ACC,11,36,130,3.6,1,11.8,8,26,3.3,0,2.4,44,156,3.5,1,,yasin-willis-1
514,Bryce Archie*,South Florida,American,12,68,129,1.9,2,10.8,0,0,,0,0.0,68,129,1.9,2,,bryce-archie-1
515,Ethan Hampton*,Northern Illinois,MAC,11,53,129,2.4,2,11.7,0,0,,0,0.0,53,129,2.4,2,,ethan-hampton-1
516,Tyler Crowe,Boise State,MWC,14,28,129,4.6,3,9.2,3,15,5.0,0,1.1,31,144,4.6,3,,tyler-crowe-1
517,Bert Emanuel Jr.,Central Michigan,MAC,3,28,128,4.6,3,42.7,0,0,,0,0.0,28,128,4.6,3,,bert-emanuel-jr-1
518,Gavin Sawchuk*,Oklahoma,SEC,9,39,128,3.3,1,14.2,8,28,3.5,0,3.1,47,156,3.3,1,,gavin-sawchuk-1
519,Rahkeem Smith*,Bowling Green,MAC,13,20,128,6.4,3,9.8,25,349,14.0,3,26.8,45,477,10.6,6,,rahkeem-smith-2
520,Samari Howard*,Army,American,14,23,128,5.6,0,9.1,2,11,5.5,0,0.8,25,139,5.6,0,,samari-howard-1
521,Anwar Lewis*,Jacksonville State,CUSA,8,35,127,3.6,2,15.9,2,49,24.5,0,6.1,37,176,4.8,2,,anwar-lewis-1
522,Fred Robertson*,Louisiana Tech,CUSA,9,33,126,3.8,0,14.0,5,43,8.6,0,4.8,38,169,4.4,0,,fred-robertson-2
523,Kadarius Calloway*,California,ACC,11,26,124,4.8,1,11.3,1,0,0.0,0,0.0,27,124,4.6,1,,kadarius-calloway-1
524,Sol-Jay Maiava-Peters,New Mexico,MWC,11,22,124,5.6,1,11.3,3,13,4.3,0,1.2,25,137,5.5,1,,sol-jay-maiava-peters-1
525,Devin Green*,Nevada-Las Vegas,MWC,12,29,123,4.2,1,10.3,0,0,,0,0.0,29,123,4.2,1,,devin-green-2
526,Jaren Mangham*,Minnesota,Big Ten,5,19,123,6.5,0,24.6,1,7,7.0,0,1.4,20,130,6.5,0,,jaren-mangham-1
527,Jawarn Howell*,South Carolina,SEC,5,19,123,6.5,2,24.6,1,5,5.0,0,1.0,20,128,6.4,2,,jawarn-howell-1
528,Keith Adams Jr.,Clemson,ACC,12,30,122,4.1,1,10.2,1,4,4.0,0,0.3,31,126,4.1,1,,keith-adams-jr-1
529,Jamauri McClure*,Tulane,American,5,20,121,6.1,1,24.2,1,24,24.0,0,4.8,21,145,6.9,1,,jamauri-mcclure-1
530,Anthony Carrie*,Georgia Tech,ACC,7,25,120,4.8,1,17.1,4,16,4.0,0,2.3,29,136,4.7,1,,anthony-carrie-1
531,Jordan Marshall*,Michigan,Big Ten,5,31,120,3.9,0,24.0,0,0,,0,0.0,31,120,3.9,0,,jordan-marshall-2
532,Nicco Marchiol*,West Virginia,Big 12,8,40,120,3.0,2,15.0,0,0,,0,0.0,40,120,3.0,2,,nicco-marchiol-1
533,Noah Vaughn,Virginia,ACC,8,36,120,3.3,0,15.0,10,77,7.7,0,9.6,46,197,4.3,0,,noah-vaughn-1
534,Charlie Offerdahl*,Colorado,Big 12,13,26,119,4.6,1,9.2,4,13,3.3,0,1.0,30,132,4.4,1,,charlie-offerdahl-1
535,Johnny Richardson,UCF,Big 12,11,25,119,4.8,0,10.8,13,91,7.0,1,8.3,38,210,5.5,1,,johnny-richardson-4
536,Cameron Seldon,Tennessee,SEC,6,23,118,5.1,1,19.7,1,-2,-2.0,0,-0.3,24,116,4.8,1,,cameron-seldon-1
537,Joey Mattord,Eastern Michigan,MAC,10,29,118,4.1,1,11.8,10,115,11.5,0,11.5,39,233,6.0,1,,joey-mattord-1
538,Joshua Wood*,Fresno State,MWC,13,37,118,3.2,6,9.1,0,0,,0,0.0,37,118,3.2,6,,joshua-wood-1
539,Tucker Kilcrease,Troy,Sun Belt,7,39,118,3.0,0,16.9,0,0,,0,0.0,39,118,3.0,0,,tucker-kilcrease-1
540,Gemari Sands,Florida Atlantic,American,11,31,117,3.8,2,10.6,3,60,20.0,0,5.5,34,177,5.2,2,,gemari-sands-1
541,Hunter Herring,Louisiana-Monroe,Sun Belt,8,16,116,7.3,2,14.5,0,0,,0,0.0,16,116,7.3,2,,hunter-herring-1
542,Jaylin Lane*,Virginia Tech,ACC,12,18,116,6.4,2,9.7,38,466,12.3,2,38.8,56,582,10.4,4,,jaylin-lane-1
543,Kedren Young*,Notre Dame,Ind,7,21,116,5.5,1,16.6,0,0,,0,0.0,21,116,5.5,1,,kedren-young-1
544,Jalen Washington,Southern Mississippi,Sun Belt,4,25,115,4.6,1,28.8,1,21,21.0,0,5.3,26,136,5.2,1,,jalen-washington-3
545,Luther Burden*,Missouri,SEC,12,9,115,12.8,2,9.6,61,676,11.1,6,56.3,70,791,11.3,8,,luther-burden-1
546,Xavier Gayten,Mississippi State,SEC,11,8,115,14.4,1,10.5,1,10,10.0,0,0.9,9,125,13.9,1,,xavier-gayten-1
547,Zach Pyron*,Georgia Tech,ACC,10,36,115,3.2,4,11.5,0,0,,0,0.0,36,115,3.2,4,,zach-pyron-1
548,Deion Brown,Eastern Michigan,MAC,11,25,114,4.6,1,10.4,4,14,3.5,0,1.3,29,128,4.4,1,,deion-brown-1
549,Jahzae Kimbrough,Kent State,MAC,8,27,114,4.2,0,14.3,5,24,4.8,0,3.0,32,138,4.3,0,,jahzae-kimbrough-1
550,Nate Johnson*,Vanderbilt,SEC,10,11,114,10.4,1,11.4,1,1,1.0,0,0.1,12,115,9.6,1,,nate-johnson-3
551,Luke Kromenhoek,Florida State,ACC,6,63,113,1.8,0,18.8,0,0,,0,0.0,63,113,1.8,0,,luke-kromenhoek-1
552,Braylon McReynolds*,South Alabama,Sun Belt,9,20,111,5.6,1,12.3,4,54,13.5,0,6.0,24,165,6.9,1,,braylon-mcreynolds-1
553,Jason Patterson,Kentucky,SEC,4,20,111,5.6,0,27.8,1,15,15.0,0,3.8,21,126,6.0,0,,jason-patterson-2
554,Larenzo McMillan,New Mexico State,CUSA,10,7,111,15.9,1,11.1,1,-1,-1.0,0,-0.1,8,110,13.8,1,,larenzo-mcmillan-1
555,Ayden Harris,Kent State,MAC,4,29,110,3.8,1,27.5,0,0,,0,0.0,29,110,3.8,1,,ayden-harris-1
556,Caleb Ramseur,Nevada,MWC,12,32,110,3.4,0,9.2,8,106,13.3,1,8.8,40,216,5.4,1,,caleb-ramseur-1
557,Dominic Richardson*,Baylor,Big 12,4,31,109,3.5,0,27.3,1,19,19.0,0,4.8,32,128,4.0,0,,dominic-richardson-1
558,Arch Manning*,Texas,SEC,10,25,108,4.3,4,10.8,0,0,,0,0.0,25,108,4.3,4,,arch-manning-1
559,Michael Allen*,Nevada-Las Vegas,MWC,3,19,108,5.7,0,36.0,0,0,,0,0.0,19,108,5.7,0,,michael-allen-3
560,Tariq Sims,Old Dominion,Sun Belt,8,32,108,3.4,2,13.5,0,0,,0,0.0,32,108,3.4,2,,tariq-sims-1
561,Dillon Bell,Georgia,SEC,13,9,107,11.9,1,8.2,43,466,10.8,4,35.8,52,573,11.0,5,,dillon-bell-1
562,Donerio Davenport*,Louisiana Tech,CUSA,4,31,107,3.5,1,26.8,7,30,4.3,0,7.5,38,137,3.6,1,,donerio-davenport-1
563,TJ Horton,Ball State,MAC,8,23,107,4.7,0,13.4,4,6,1.5,0,0.8,27,113,4.2,0,,tj-horton-2
564,Derrick McFall,SMU,ACC,5,26,106,4.1,2,21.2,3,30,10.0,0,6.0,29,136,4.7,2,,derrick-mcfall-1
565,Gabarri Johnson,Oregon State,Ind,6,26,106,4.1,1,17.7,0,0,,0,0.0,26,106,4.1,1,,gabarri-johnson-1
566,Jacory Croskey-Merritt,Arizona,Big 12,1,13,106,8.2,1,106.0,0,0,,0,0.0,13,106,8.2,1,,jacory-croskey-merritt-1
567,JQ Gray,Southern Mississippi,Sun Belt,12,32,106,3.3,0,8.8,3,13,4.3,0,1.1,35,119,3.4,0,,jq-gray-1
568,Makari Bodiford*,Memphis,American,7,15,106,7.1,1,15.1,1,3,3.0,0,0.4,16,109,6.8,1,,makari-bodiford-1
569,Fernando Mendoza*,California,ACC,11,87,105,1.2,2,9.5,0,15,,1,1.4,87,120,1.4,3,,fernando-mendoza-1
570,Jake Rendina*,Army,American,14,29,104,3.6,1,7.4,0,0,,0,0.0,29,104,3.6,1,,jake-rendina-1
571,Johnathan Arceneaux*,Fresno State,MWC,11,22,104,4.7,0,9.5,4,42,10.5,0,3.8,26,146,5.6,0,,johnathan-arceneaux-1
572,Kewan Lacy*,Missouri,SEC,6,23,104,4.5,0,17.3,2,9,4.5,0,1.5,25,113,4.5,0,,kewan-lacy-1
573,Jacolby Criswell*,North Carolina,ACC,12,71,103,1.5,3,8.6,0,-2,,0,-0.2,71,101,1.4,3,,jacolby-criswell-1
574,L.T. Sanders*,Western Kentucky,CUSA,9,21,103,4.9,1,11.4,3,7,2.3,0,0.8,24,110,4.6,1,,lt-sanders-1
575,DJ Butler,Houston,Big 12,8,16,102,6.4,0,12.8,4,36,9.0,0,4.5,20,138,6.9,0,,dj-butler-2
576,Heinrich Haarberg*,Nebraska,Big Ten,12,25,102,4.1,1,8.5,2,16,8.0,0,1.3,27,118,4.4,1,,heinrich-haarberg-1
577,Terry Bussey*,Texas A&M,SEC,12,16,102,6.4,2,8.5,17,216,12.7,0,18.0,33,318,9.6,2,,terry-bussey-1
578,Antonio Williams,Clemson,ACC,14,7,101,14.4,1,7.2,75,904,12.1,11,64.6,82,1005,12.3,12,,antonio-williams-2
579,Christian Vaughn,Hawaii,MWC,6,16,101,6.3,0,16.8,0,0,,0,0.0,16,101,6.3,0,,christian-vaughn-1
580,Conner Weigman*,Texas A&M,SEC,6,28,101,3.6,0,16.8,0,0,,0,0.0,28,101,3.6,0,,conner-weigman-1
581,Deamonte Trayanum,Kentucky,SEC,3,19,101,5.3,0,33.7,0,0,,0,0.0,19,101,5.3,0,,deamonte-trayanum-1
582,DJ Lagway*,Florida,SEC,12,51,101,2.0,0,8.4,0,0,,0,0.0,51,101,2.0,0,,dj-lagway-1
583,Jacob De Jesus*,Nevada-Las Vegas,MWC,13,18,101,5.6,0,7.8,36,512,14.2,3,39.4,54,613,11.4,3,,jacob-de-jesus-1
584,Jeff Sims,Arizona State,Big 12,4,24,101,4.2,1,25.3,0,0,,0,0.0,24,101,4.2,1,,jeff-sims-1
585,Ja'shon Benjamin*,Rutgers,Big Ten,4,19,100,5.3,1,25.0,3,12,4.0,1,3.0,22,112,5.1,2,,jashon-benjamin-1
586,Khalifa Keith,Tennessee,SEC,4,21,100,4.8,1,25.0,1,8,8.0,0,2.0,22,108,4.9,1,,khalifa-keith-1
587,Ryan Wingo*,Texas,SEC,16,5,100,20.0,0,6.3,29,472,16.3,2,29.5,34,572,16.8,2,,ryan-wingo-1
588,Tyler King,Wyoming,MWC,10,13,100,7.7,2,10.0,17,236,13.9,0,23.6,30,336,11.2,2,,tyler-king-5
589,Colin Page*,Texas,SEC,5,18,99,5.5,0,19.8,0,0,,0,0.0,18,99,5.5,0,,colin-page-1
590,Jambres Dubar,Boise State,MWC,7,25,99,4.0,2,14.1,2,18,9.0,0,2.6,27,117,4.3,2,,jambres-dubar-1
591,Rodney Fields Jr.,Oklahoma State,Big 12,4,21,99,4.7,1,24.8,2,23,11.5,0,5.8,23,122,5.3,1,,rodney-fields-jr-1
592,Sesi Vailahi,Oklahoma State,Big 12,12,42,99,2.4,2,8.3,8,46,5.8,0,3.8,50,145,2.9,2,,sesi-vailahi-1
593,Walker Eget*,San Jose State,MWC,12,29,99,3.4,0,8.3,0,0,,0,0.0,29,99,3.4,0,,walker-eget-1
594,Enoch Nawahine*,BYU,Big 12,10,30,98,3.3,1,9.8,1,1,1.0,0,0.1,31,99,3.2,1,,enoch-nawahine-2
595,Isaiah Bond*,Texas,SEC,14,4,98,24.5,1,7.0,34,540,15.9,5,38.6,38,638,16.8,6,,isaiah-bond-1
596,PJ Martin*,South Alabama,Sun Belt,13,13,98,7.5,1,7.5,3,33,11.0,0,2.5,16,131,8.2,1,,pj-martin-1
597,Tony Muskett,Virginia,ACC,8,27,98,3.6,4,12.3,0,0,,0,0.0,27,98,3.6,4,,tony-muskett-1
598,Brock Glenn,Florida State,ACC,7,35,97,2.8,0,13.9,0,0,,0,0.0,35,97,2.8,0,,brock-glenn-1
599,Elijah Jackson,Purdue,Big Ten,11,6,97,16.2,1,8.8,2,7,3.5,0,0.6,8,104,13.0,1,,elijah-jackson-3
600,Jacob Zeno,UAB,American,4,37,97,2.6,0,24.3,0,0,,0,0.0,37,97,2.6,0,,jacob-zeno-1
601,Keegan Holles*,Colorado State,MWC,3,15,97,6.5,1,32.3,1,4,4.0,0,1.3,16,101,6.3,1,,keegan-holles-1
602,Parker Awad,New Mexico State,CUSA,7,61,97,1.6,1,13.9,0,0,,0,0.0,61,97,1.6,1,,parker-awad-1
603,Sy'veon Wilkerson,Georgia State,Sun Belt,4,23,97,4.2,0,24.3,1,3,3.0,0,0.8,24,100,4.2,0,,syveon-wilkerson-1
604,Keelan Marion*,BYU,Big 12,13,21,96,4.6,2,7.4,24,346,14.4,1,26.6,45,442,9.8,3,,keelan-marion-1
605,Josh Johnson,Air Force,MWC,6,14,94,6.7,0,15.7,0,0,,0,0.0,14,94,6.7,0,,josh-johnson-10
606,Justin Lamson,Stanford,ACC,12,68,94,1.4,8,7.8,0,0,,0,0.0,68,94,1.4,8,,justin-lamson-1
607,Will Henderson III*,UTSA,American,5,14,94,6.7,1,18.8,4,16,4.0,0,3.2,18,110,6.1,1,,will-henderson-iii-1
608,Danny O'Neil,San Diego State,MWC,11,73,93,1.3,1,8.5,0,0,,0,0.0,73,93,1.3,1,,danny-oneil-2
609,Ja'Vin Simpkins*,Coastal Carolina,Sun Belt,3,14,93,6.6,0,31.0,0,0,,0,0.0,14,93,6.6,0,,javin-simpkins-1
610,Samuel Singleton Jr.,Florida State,ACC,9,21,93,4.4,0,10.3,3,3,1.0,0,0.3,24,96,4.0,0,,samuel-singleton-jr-1
611,Treyaun Webb*,Florida,SEC,4,21,93,4.4,1,23.3,0,0,,0,0.0,21,93,4.4,1,,treyaun-webb-1
612,Brandon Nunez,New Mexico State,CUSA,6,26,92,3.5,2,15.3,0,0,,0,0.0,26,92,3.5,2,,brandon-nunez-1
613,Javious Bond*,East Carolina,American,4,14,92,6.6,1,23.0,0,0,,0,0.0,14,92,6.6,1,,javious-bond-1
614,Aiden Calvert,Air Force,MWC,5,18,91,5.1,2,18.2,1,21,21.0,0,4.2,19,112,5.9,2,,aiden-calvert-1
615,Garret Rangel,Oklahoma State,Big 12,4,9,91,10.1,0,22.8,0,0,,0,0.0,9,91,10.1,0,,garret-rangel-1
616,Jhari Patterson*,East Carolina,American,13,7,91,13.0,0,7.0,33,281,8.5,1,21.6,40,372,9.3,1,,jhari-patterson-1
617,Juju McDowell*,South Carolina,SEC,13,22,91,4.1,0,7.0,2,14,7.0,1,1.1,24,105,4.4,1,,juju-mcdowell-1
618,Kiael Kelly,Ball State,MAC,11,35,91,2.6,1,8.3,4,-19,-4.8,0,-1.7,39,72,1.8,1,,kiael-kelly-1
619,Winston Wright*,East Carolina,American,11,13,91,7.0,0,8.3,54,556,10.3,8,50.5,67,647,9.7,8,,winston-wright-1
620,Makai Jackson,Appalachian State,Sun Belt,11,5,90,18.0,1,8.2,46,745,16.2,5,67.7,51,835,16.4,6,,makai-jackson-1
621,Armoni Goodwin,UAB,American,5,14,88,6.3,0,17.6,2,23,11.5,1,4.6,16,111,6.9,1,,armoni-goodwin-1
622,Chandler Fields*,Louisiana,Sun Belt,7,26,88,3.4,2,12.6,0,0,,0,0.0,26,88,3.4,2,,chandler-fields-1
623,Dilin Jones,Wisconsin,Big Ten,3,16,88,5.5,0,29.3,0,0,,0,0.0,16,88,5.5,0,,dilin-jones-1
624,Julian Dugger*,Pitt,ACC,1,21,88,4.2,1,88.0,0,0,,0,0.0,21,88,4.2,1,,julian-dugger-1
625,Robert Briggs,Utah State,MWC,1,9,88,9.8,0,88.0,3,38,12.7,0,38.0,12,126,10.5,0,,robert-briggs-1
626,Terrance Shelton*,Buffalo,MAC,13,23,88,3.8,0,6.8,0,0,,0,0.0,23,88,3.8,0,,terrance-shelton-1
627,Xavier Townsend,UCF,Big 12,4,12,88,7.3,0,22.0,10,69,6.9,1,17.3,22,157,7.1,1,,xavier-townsend-1
628,Caleb Goodie*,Colorado State,MWC,11,5,87,17.4,0,7.9,21,436,20.8,4,39.6,26,523,20.1,4,,caleb-goodie-1
629,Dontae McMillan,Eastern Michigan,MAC,2,23,87,3.8,0,43.5,2,1,0.5,0,0.5,25,88,3.5,0,,dontae-mcmillan-1
630,Drew Mestemaker*,North Texas,American,5,14,87,6.2,1,17.4,0,0,,0,0.0,14,87,6.2,1,,drew-mestemaker-1
631,Malik Rutherford*,Georgia Tech,ACC,13,9,87,9.7,0,6.7,62,702,11.3,3,54.0,71,789,11.1,3,,malik-rutherford-1
632,Chandler Rogers*,California,ACC,8,29,86,3.0,1,10.8,1,3,3.0,0,0.4,30,89,3.0,1,,chandler-rogers-3
633,DT Sheffield*,North Texas,American,12,4,86,21.5,1,7.2,66,822,12.5,11,68.5,70,908,13.0,12,,dt-sheffield-1
634,Jaquez Moore*,Duke,ACC,5,32,86,2.7,1,17.2,3,4,1.3,0,0.8,35,90,2.6,1,,jaquez-moore-1
635,Malik Hornsby*,Arkansas State,Sun Belt,13,5,86,17.2,1,6.6,7,39,5.6,0,3.0,12,125,10.4,1,,malik-hornsby-1
636,Tim Carpenter,Tulsa,American,4,11,86,7.8,0,21.5,0,0,,0,0.0,11,86,7.8,0,,tim-carpenter-2
637,Preston Daniels,Kennesaw State,CUSA,12,35,85,2.4,3,7.1,2,18,9.0,0,1.5,37,103,2.8,3,,preston-daniels-1
638,Caziah Holmes,Florida State,ACC,12,15,84,5.6,3,7.0,0,0,,0,0.0,15,84,5.6,3,,caziah-holmes-1
639,Charleston French*,North Carolina,ACC,4,10,84,8.4,1,21.0,1,2,2.0,0,0.5,11,86,7.8,1,,charleston-french-1
640,Duncan Brune*,Ohio,MAC,14,26,84,3.2,1,6.0,0,0,,0,0.0,26,84,3.2,1,,duncan-brune-1
641,Mike Wright,Northwestern,Big Ten,3,18,84,4.7,1,28.0,0,0,,0,0.0,18,84,4.7,1,,mike-wright-8
642,Cameran Brown*,Texas Tech,Big 12,8,8,83,10.4,0,10.4,0,0,,0,0.0,8,83,10.4,0,,cameran-brown-1
643,Shane Reynolds*,Navy,American,11,23,83,3.6,1,7.5,0,0,,0,0.0,23,83,3.6,1,,shane-reynolds-1
644,Tyrell Robinson*,Army,American,8,20,83,4.2,0,10.4,4,50,12.5,1,6.3,24,133,5.5,1,,tyrell-robinson-2
645,Da'Jaun Riggs,Oregon,Big Ten,2,11,82,7.5,1,41.0,0,0,,0,0.0,11,82,7.5,1,,dajaun-riggs-1
646,Caleb Hood*,North Carolina,ACC,5,18,81,4.5,0,16.2,4,37,9.3,0,7.4,22,118,5.4,0,,caleb-hood-1
647,Justin Lynch*,Northern Illinois,MAC,13,18,81,4.5,0,6.2,4,14,3.5,0,1.1,22,95,4.3,0,,justin-lynch-1
648,Noah Smith*,Sam Houston,CUSA,11,13,81,6.2,0,7.4,40,313,7.8,0,28.5,53,394,7.4,0,,noah-smith-3
649,Pokaiaua Haunga*,BYU,Big 12,5,18,81,4.5,0,16.2,5,43,8.6,0,8.6,23,124,5.4,0,,pokaiaua-haunga-1
650,Solomon Beebe,UAB,American,10,22,81,3.7,1,8.1,2,12,6.0,0,1.2,24,93,3.9,1,,solomon-beebe-1
651,JC Evans*,James Madison,Sun Belt,3,15,80,5.3,1,26.7,0,0,,0,0.0,15,80,5.3,1,,jc-evans-1
652,Grayson James*,Boston College,ACC,6,37,79,2.1,3,13.2,0,0,,0,0.0,37,79,2.1,3,,grayson-james-1
653,Christian Francisco,Rice,American,8,19,78,4.1,0,9.8,8,62,7.8,1,7.8,27,140,5.2,1,,christian-francisco-1
654,Jaheim Merriweather,Purdue,Big Ten,11,15,77,5.1,1,7.0,3,21,7.0,0,1.9,18,98,5.4,1,,jaheim-merriweather-1
655,KD Daniels*,Florida,SEC,4,11,77,7.0,1,19.3,0,0,,0,0.0,11,77,7.0,1,,kd-daniels-1
656,Aaron Philo*,Georgia Tech,ACC,5,12,76,6.3,1,15.2,0,0,,0,0.0,12,76,6.3,1,,aaron-philo-1
657,Cam Davis,San Diego State,MWC,8,14,76,5.4,0,9.5,4,6,1.5,0,0.8,18,82,4.6,0,,cam-davis-1
658,Che Nwabuko*,Pitt,ACC,7,6,76,12.7,1,10.9,2,15,7.5,0,2.1,8,91,11.4,1,,che-nwabuko-1
659,Ife Adeyi*,Sam Houston,CUSA,13,9,76,8.4,1,5.8,30,271,9.0,1,20.8,39,347,8.9,2,,ife-adeyi-1
660,Miles Davis*,BYU,Big 12,8,18,76,4.2,0,9.5,5,68,13.6,1,8.5,23,144,6.3,1,,miles-davis-1
661,Nolan McCormick*,Ohio,MAC,9,20,76,3.8,2,8.4,1,2,2.0,0,0.2,21,78,3.7,2,,nolan-mccormick-1
662,Will Nixon*,Syracuse,ACC,3,19,76,4.0,0,25.3,4,44,11.0,0,14.7,23,120,5.2,0,,will-nixon-1
663,Zavion Thomas*,LSU,SEC,13,9,76,8.4,0,5.8,23,218,9.5,2,16.8,32,294,9.2,2,,zavion-thomas-1
664,Brayden Fowler-Nicolosi*,Colorado State,MWC,13,43,75,1.7,4,5.8,1,6,6.0,1,0.5,44,81,1.8,5,,brayden-fowler-nicolosi-1
665,Byron Cardwell*,California,ACC,9,24,75,3.1,0,8.3,2,31,15.5,0,3.4,26,106,4.1,0,,byron-cardwell-1
666,John Gentry*,Sam Houston,CUSA,11,26,75,2.9,1,6.8,6,16,2.7,1,1.5,32,91,2.8,2,,john-gentry-1
667,Rashad Amos*,Ole Miss,SEC,6,9,75,8.3,0,12.5,0,0,,0,0.0,9,75,8.3,0,,rashad-amos-1
668,Christian Veilleux,Georgia State,Sun Belt,10,28,74,2.6,1,7.4,0,0,,0,0.0,28,74,2.6,1,,christian-veilleux-1
669,Jordyn Bailey*,Texas Christian,Big 12,12,3,74,24.7,1,6.2,9,52,5.8,2,4.3,12,126,10.5,3,,jordyn-bailey-1
670,Kemper Hodges,Air Force,MWC,11,19,74,3.9,1,6.7,0,0,,0,0.0,19,74,3.9,1,,kemper-hodges-1
671,Malachi Singleton*,Arkansas,SEC,5,17,74,4.4,3,14.8,0,0,,0,0.0,17,74,4.4,3,,malachi-singleton-1
672,Branson Robinson,Georgia,SEC,6,25,73,2.9,3,12.2,6,33,5.5,0,5.5,31,106,3.4,3,,branson-robinson-1
673,Datrell Jones*,Boston College,ACC,5,8,73,9.1,1,14.6,0,0,,0,0.0,8,73,9.1,1,,datrell-jones-1
674,Khobie Martin,Indiana,Big Ten,2,14,73,5.2,0,36.5,0,0,,0,0.0,14,73,5.2,0,,khobie-martin-1
675,Tayven Jackson,Indiana,Big Ten,7,15,73,4.9,3,10.4,0,0,,0,0.0,15,73,4.9,3,,tayven-jackson-1
676,Tylon Citizen*,Louisiana,Sun Belt,11,10,73,7.3,0,6.6,0,0,,0,0.0,10,73,7.3,0,,tylon-citizen-1
677,Benjamin Hall*,Michigan,Big Ten,8,29,72,2.5,0,9.0,3,12,4.0,0,1.5,32,84,2.6,0,,benjamin-hall-1
678,Henry Rutledge,Charlotte,American,12,11,72,6.5,0,6.0,10,82,8.2,1,6.8,21,154,7.3,1,,henry-rutledge-1
679,Max Brown,Charlotte,American,5,33,72,2.2,0,14.4,0,0,,0,0.0,33,72,2.2,0,,max-brown-1
680,Trebor Pena*,Syracuse,ACC,13,12,72,6.0,1,5.5,84,941,11.2,9,72.4,96,1013,10.6,10,,trebor-pena-1
681,Victor Rosa*,Connecticut,Ind,5,16,72,4.5,1,14.4,2,16,8.0,0,3.2,18,88,4.9,1,,victor-rosa-1
682,Carson Beck,Georgia,SEC,13,55,71,1.3,1,5.5,0,0,,0,0.0,55,71,1.3,1,,carson-beck-1
683,CJ Beasley,Georgia State,Sun Belt,5,13,71,5.5,0,14.2,3,16,5.3,0,3.2,16,87,5.4,0,,cj-beasley-1
684,Jayden Limar,Oregon,Big Ten,14,25,71,2.8,0,5.1,2,71,35.5,1,5.1,27,142,5.3,1,,jayden-limar-1
685,Kasen Weisman,Florida Atlantic,American,7,15,71,4.7,1,10.1,0,0,,0,0.0,15,71,4.7,1,,kasen-weisman-2
686,Derrick Davis Jr.*,Pitt,ACC,12,27,70,2.6,2,5.8,3,15,5.0,0,1.3,30,85,2.8,2,,derrick-davis-jr-1
687,Jackson Paradis,Massachusetts,Ind,7,21,70,3.3,1,10.0,0,0,,0,0.0,21,70,3.3,1,,jackson-paradis-1
688,Ryan Burger*,Liberty,CUSA,5,17,70,4.1,1,14.0,0,0,,0,0.0,17,70,4.1,1,,ryan-burger-1
689,J.J. Pegues*,Ole Miss,SEC,13,21,69,3.3,7,5.3,0,0,,0,0.0,21,69,3.3,7,,jj-pegues-1
690,Sedrick Irvin,Stanford,ACC,6,18,69,3.8,0,11.5,5,107,21.4,0,17.8,23,176,7.7,0,,sedrick-irvin-2
691,Christopher Vizzina,Clemson,ACC,7,13,68,5.2,1,9.7,0,0,,0,0.0,13,68,5.2,1,,christopher-vizzina-1
692,Chance Williams,Cincinnati,Big 12,4,15,67,4.5,0,16.8,0,0,,0,0.0,15,67,4.5,0,,chance-williams-1
693,JD Sherrod,Kent State,MAC,2,13,67,5.2,0,33.5,0,0,,0,0.0,13,67,5.2,0,,jd-sherrod-1
694,Lucian Anderson III*,Bowling Green,MAC,8,19,67,3.5,2,8.4,0,0,,0,0.0,19,67,3.5,2,,lucian-anderson-iii-1
695,Micah Alejado,Hawaii,MWC,4,20,67,3.4,0,16.8,0,0,,0,0.0,20,67,3.4,0,,micah-alejado-1
696,Raylen Sharpe*,Fresno State,MWC,11,4,67,16.8,0,6.1,51,523,10.3,3,47.5,55,590,10.7,3,,raylen-sharpe-1
697,Trelain Maddox*,Georgia Tech,ACC,2,17,67,3.9,1,33.5,1,9,9.0,0,4.5,18,76,4.2,1,,trelain-maddox-1
698,Ahmonte Watkins,New Mexico State,CUSA,6,16,66,4.1,0,11.0,2,69,34.5,1,11.5,18,135,7.5,1,,ahmonte-watkins-1
699,Ayden Greene*,Virginia Tech,ACC,13,9,66,7.3,1,5.1,19,268,14.1,2,20.6,28,334,11.9,3,,ayden-greene-1
700,Brandon Rose,Utah,Big 12,3,11,66,6.0,0,22.0,0,0,,0,0.0,11,66,6.0,0,,brandon-rose-1
701,DeQuan Finn*,Baylor,Big 12,3,21,66,3.1,2,22.0,0,0,,0,0.0,21,66,3.1,2,,dequan-finn-1
702,Dijon Stanley,Utah,Big 12,12,20,66,3.3,0,5.5,7,166,23.7,2,13.8,27,232,8.6,2,,dijon-stanley-1
703,Rueben Owens*,Texas A&M,SEC,2,16,66,4.1,0,33.0,1,6,6.0,0,3.0,17,72,4.2,0,,rueben-owens-1
704,A'Marion Peterson*,USC,Big Ten,10,16,65,4.1,1,6.5,2,13,6.5,0,1.3,18,78,4.3,1,,amarion-peterson-1
705,Cardell Williams,Tulsa,American,7,13,65,5.0,2,9.3,0,0,,0,0.0,13,65,5.0,2,,cardell-williams-1
706,Harold Fannin Jr.*,Bowling Green,MAC,13,9,65,7.2,1,5.0,117,1555,13.3,10,119.6,126,1620,12.9,11,AA,harold-fannin-jr-1
707,Hauss Hejny*,Texas Christian,Big 12,4,15,65,4.3,0,16.3,0,0,,0,0.0,15,65,4.3,0,,hauss-hejny-1
708,Juwuan Price*,North Texas,American,2,14,64,4.6,0,32.0,2,14,7.0,0,7.0,16,78,4.9,0,,juwuan-price-1
709,Nick Floyd,Utah State,MWC,2,5,64,12.8,0,32.0,0,0,,0,0.0,5,64,12.8,0,,nick-floyd-1
710,Cam Wallace*,Penn State,Big Ten,3,18,63,3.5,1,21.0,0,0,,0,0.0,18,63,3.5,1,,cam-wallace-1
711,Dominique Johnson*,Texas Christian,Big 12,12,18,63,3.5,1,5.3,1,2,2.0,0,0.2,19,65,3.4,1,,dominique-johnson-2
712,Landon Robinson*,Navy,American,13,2,63,31.5,0,4.8,0,0,,0,0.0,2,63,31.5,0,,landon-robinson-1
713,Myles Price,Indiana,Big Ten,13,7,63,9.0,1,4.8,38,466,12.3,3,35.8,45,529,11.8,4,,myles-price-1
714,Tyriq Starks,Florida Atlantic,American,5,23,63,2.7,0,12.6,0,0,,0,0.0,23,63,2.7,0,,tyriq-starks-1
715,Victor Dawson,Cincinnati,Big 12,11,7,63,9.0,0,5.7,0,0,,0,0.0,7,63,9.0,0,,victor-dawson-1
716,Darwin Barlow*,North Carolina,ACC,5,9,62,6.9,0,12.4,3,31,10.3,0,6.2,12,93,7.8,0,,darwin-barlow-1
717,David Eziomume,Clemson,ACC,5,10,62,6.2,0,12.4,0,0,,0,0.0,10,62,6.2,0,,david-eziomume-1
718,Julian Gray*,Liberty,CUSA,8,10,62,6.2,1,7.8,7,97,13.9,2,12.1,17,159,9.4,3,,julian-gray-1
719,Manny Covey,Cincinnati,Big 12,12,17,62,3.6,0,5.2,8,119,14.9,2,9.9,25,181,7.2,2,,manny-covey-1
720,Taylor Latham,Air Force,MWC,11,22,62,2.8,1,5.6,6,93,15.5,1,8.5,28,155,5.5,2,,taylor-latham-1
721,Timothy Gans,New Mexico State,CUSA,5,16,62,3.9,0,12.4,3,24,8.0,0,4.8,19,86,4.5,0,,timothy-gans-1
722,Daniel Hill*,Alabama,SEC,9,21,61,2.9,1,6.8,1,3,3.0,0,0.3,22,64,2.9,1,,daniel-hill-1
723,James Jointer*,Liberty,CUSA,7,12,61,5.1,0,8.7,0,0,,0,0.0,12,61,5.1,0,,james-jointer-1
724,John Emery Jr.*,LSU,SEC,1,10,61,6.1,0,61.0,1,10,10.0,0,10.0,11,71,6.5,0,,john-emery-jr-1
725,Victor Snow*,Buffalo,MAC,13,9,61,6.8,2,4.7,55,651,11.8,6,50.1,64,712,11.1,8,,victor-snow-1
726,Chubba Purdy,Nevada,MWC,7,13,60,4.6,0,8.6,2,10,5.0,0,1.4,15,70,4.7,0,,chubba-purdy-1
727,Jamal Hailey*,Western Michigan,MAC,11,6,60,10.0,1,5.5,0,0,,0,0.0,6,60,10.0,1,,jamal-hailey-1
728,Jaylon Glover,Utah,Big 12,3,12,60,5.0,0,20.0,0,0,,0,0.0,12,60,5.0,0,,jaylon-glover-1
729,Joe Fagnano*,Connecticut,Ind,10,30,60,2.0,1,6.0,0,0,,0,0.0,30,60,2.0,1,,joe-fagnano-1
730,Zachary Card,Oregon State,Ind,12,5,60,12.0,1,5.0,0,0,,0,0.0,5,60,12.0,1,,zachary-card-1
731,Eric Wilson Jr.,Temple,American,4,16,59,3.7,0,14.8,4,19,4.8,0,4.8,20,78,3.9,0,,eric-wilson-jr-1
732,Nicholas Vattiato,Middle Tennessee State,CUSA,12,86,59,0.7,1,4.9,0,0,,0,0.0,86,59,0.7,1,,nicholas-vattiato-1
733,Aiden Armenta,Louisiana-Monroe,Sun Belt,12,47,58,1.2,1,4.8,0,0,,0,0.0,47,58,1.2,1,,aiden-armenta-1
734,Chauncey Bowers,Georgia,SEC,4,16,58,3.6,0,14.5,0,0,,0,0.0,16,58,3.6,0,,chauncey-bowers-1
735,Ikaika Ragsdale*,North Texas,American,2,22,58,2.6,1,29.0,4,13,3.3,0,6.5,26,71,2.7,1,,ikaika-ragsdale-1
736,Tray Taylor*,Coastal Carolina,Sun Belt,13,6,58,9.7,0,4.5,18,262,14.6,1,20.2,24,320,13.3,1,,tray-taylor-1
737,Zach Evans*,North Texas,American,2,9,58,6.4,0,29.0,4,10,2.5,0,5.0,13,68,5.2,0,,zach-evans-2
738,Anthony Eager*,South Alabama,Sun Belt,13,5,57,11.4,0,4.4,10,133,13.3,2,10.2,15,190,12.7,2,,anthony-eager-1
739,David Cordero,Hawaii,MWC,10,10,57,5.7,0,5.7,1,-1,-1.0,0,-0.1,11,56,5.1,0,,david-cordero-1
740,Jalen Hampton*,Western Kentucky,CUSA,7,11,57,5.2,0,8.1,0,0,,0,0.0,11,57,5.2,0,,jalen-hampton-1
741,Kyle Lowe,Georgia State,Sun Belt,5,9,57,6.3,1,11.4,0,0,,0,0.0,9,57,6.3,1,,kyle-lowe-2
742,Kyle Williams*,Washington State,Ind,13,9,57,6.3,0,4.4,70,1198,17.1,14,92.2,79,1255,15.9,14,,kyle-williams-11
743,Ty Clark,Wake Forest,ACC,11,13,57,4.4,0,5.2,1,1,1.0,0,0.1,14,58,4.1,0,,ty-clark-1
744,Brennan Presley,Oklahoma State,Big 12,12,7,56,8.0,1,4.7,90,767,8.5,7,63.9,97,823,8.5,8,,brennan-presley-1
745,Cameron Ross*,James Madison,Sun Belt,13,4,56,14.0,0,4.3,37,443,12.0,3,34.1,41,499,12.2,3,,cameron-ross-1
746,Cole Turner,Clemson,ACC,14,5,56,11.2,1,4.0,16,229,14.3,2,16.4,21,285,13.6,3,,cole-turner-3
747,Graham Mertz*,Florida,SEC,5,18,56,3.1,1,11.2,0,0,,0,0.0,18,56,3.1,1,,graham-mertz-1
748,Kaden Shields-Dutton,Florida Atlantic,American,5,12,56,4.7,0,11.2,0,0,,0,0.0,12,56,4.7,0,,kaden-shields-dutton-1
749,Roman Bradley,Air Force,MWC,2,21,56,2.7,0,28.0,0,0,,0,0.0,21,56,2.7,0,,roman-bradley-1
750,Yasias Young*,South Florida,American,12,16,56,3.5,0,4.7,0,0,,0,0.0,16,56,3.5,0,,yasias-young-1
751,Ashton Allen,Temple,American,12,6,55,9.2,0,4.6,24,324,13.5,2,27.0,30,379,12.6,2,,ashton-allen-1
752,Conner Harrell*,North Carolina,ACC,6,16,55,3.4,1,9.2,0,0,,0,0.0,16,55,3.4,1,,conner-harrell-1
753,Devyn Ford*,Notre Dame,Ind,13,13,55,4.2,0,4.2,2,6,3.0,0,0.5,15,61,4.1,0,,devyn-ford-1
754,Jack Griese,Virginia,ACC,4,15,55,3.7,0,13.8,1,57,57.0,1,14.3,16,112,7.0,1,,jack-griese-1
755,Jordin Parker*,Western Michigan,MAC,11,3,55,18.3,0,5.0,12,140,11.7,0,12.7,15,195,13.0,0,,jordin-parker-1
756,Luke Wysong,New Mexico,MWC,11,9,55,6.1,0,5.0,69,840,12.2,1,76.4,78,895,11.5,1,,luke-wysong-1
757,Mike Franklin*,Jacksonville State,CUSA,4,8,55,6.9,1,13.8,0,0,,0,0.0,8,55,6.9,1,,mike-franklin-1
758,Tavorus Jones*,Missouri,SEC,5,13,55,4.2,0,11.0,1,20,20.0,0,4.0,14,75,5.4,0,,tavorus-jones-1
759,Arian Smith,Georgia,SEC,14,5,54,10.8,0,3.9,48,817,17.0,4,58.4,53,871,16.4,4,,arian-smith-1
760,Jamoni Jones*,Vanderbilt,SEC,13,18,54,3.0,0,4.2,0,0,,0,0.0,18,54,3.0,0,,jamoni-jones-1
761,Aiden Flora*,Iowa State,Big 12,7,11,53,4.8,1,7.6,1,6,6.0,0,0.9,12,59,4.9,1,,aiden-flora-1
762,Grayson McCall*,North Carolina State,ACC,4,19,53,2.8,0,13.3,0,0,,0,0.0,19,53,2.8,0,,grayson-mccall-1
763,Jarvis Green,Clemson,ACC,9,9,53,5.9,0,5.9,2,35,17.5,1,3.9,11,88,8.0,1,,jarvis-green-2
764,Jordan Lovett,Troy,Sun Belt,5,17,53,3.1,1,10.6,8,56,7.0,0,11.2,25,109,4.4,1,,jordan-lovett-2
765,Roydell Williams,Florida State,ACC,4,26,53,2.0,2,13.3,5,46,9.2,0,11.5,31,99,3.2,2,,roydell-williams-2
766,Sam Williams-Dixon*,Ohio State,Big Ten,4,7,53,7.6,0,13.3,0,0,,0,0.0,7,53,7.6,0,,sam-williams-dixon-1
767,Zach Gibson,Georgia State,Sun Belt,7,43,53,1.2,1,7.6,0,0,,0,0.0,43,53,1.2,1,,zach-gibson-1
768,Ben Finley,Akron,MAC,12,81,52,0.6,0,4.3,2,15,7.5,0,1.3,83,67,0.8,0,,ben-finley-1
769,Bradley Dunn*,South Carolina,SEC,3,8,52,6.5,1,17.3,1,13,13.0,0,4.3,9,65,7.2,1,,bradley-dunn-1
770,Will Crowder,Troy,Sun Belt,4,18,52,2.9,1,13.0,0,0,,0,0.0,18,52,2.9,1,,will-crowder-1
771,Carson Smith*,Army,American,8,12,51,4.3,0,6.4,0,0,,0,0.0,12,51,4.3,0,,carson-smith-3
772,Chase Gillespie*,Vanderbilt,SEC,11,15,51,3.4,0,4.6,1,6,6.0,0,0.5,16,57,3.6,0,,chase-gillespie-1
773,Connor Moberly*,Iowa State,Big 12,4,8,51,6.4,0,12.8,0,0,,0,0.0,8,51,6.4,0,,connor-moberly-1
774,Justin Pegues*,Bowling Green,MAC,13,13,51,3.9,0,3.9,11,44,4.0,0,3.4,24,95,4.0,0,,justin-pegues-1
775,K.D. Hutchinson*,Western Kentucky,CUSA,14,8,51,6.4,0,3.6,25,383,15.3,3,27.4,33,434,13.2,3,,kd-hutchinson-1
776,Nathan Kent*,Navy,American,13,2,51,25.5,1,3.9,10,222,22.2,2,17.1,12,273,22.8,3,,nathan-kent-1
777,Rodney Gallagher*,West Virginia,Big 12,13,16,51,3.2,0,3.9,26,288,11.1,3,22.2,42,339,8.1,3,,rodney-gallagher-1
778,Alvon Isaac*,South Florida,American,4,6,50,8.3,1,12.5,0,0,,0,0.0,6,50,8.3,1,,alvon-isaac-1
779,Anthony DiNota*,Texas A&M,SEC,13,13,50,3.8,0,3.8,2,16,8.0,0,1.2,15,66,4.4,0,,anthony-dinota-1
780,Anthony Evans III,Georgia,SEC,11,3,50,16.7,0,4.5,9,88,9.8,0,8.0,12,138,11.5,0,,anthony-evans-iii-1
781,Barion Brown,Kentucky,SEC,11,13,50,3.8,1,4.5,29,361,12.4,3,32.8,42,411,9.8,4,,barion-brown-1
782,John Henderson*,Bowling Green,MAC,13,4,50,12.5,0,3.8,0,0,,0,0.0,4,50,12.5,0,,john-henderson-5
783,Kameron Shanks,UAB,American,12,8,50,6.3,0,4.2,62,656,10.6,6,54.7,70,706,10.1,6,,kameron-shanks-1
784,Keldric Luster,SMU,ACC,5,11,50,4.5,0,10.0,0,0,,0,0.0,11,50,4.5,0,,keldric-luster-1
785,CJ Harris*,California,ACC,2,18,49,2.7,0,24.5,0,0,,0,0.0,18,49,2.7,0,,cj-harris-2
786,Frank Peasant,Middle Tennessee State,CUSA,2,10,49,4.9,2,24.5,2,3,1.5,0,1.5,12,52,4.3,2,,frank-peasant-1
787,Kaden Anderson,Wyoming,MWC,9,22,49,2.2,2,5.4,0,0,,0,0.0,22,49,2.2,2,,kaden-anderson-1
788,Will Hammond*,Texas Tech,Big 12,4,17,49,2.9,2,12.3,0,0,,0,0.0,17,49,2.9,2,,will-hammond-1
789,Ross Fournet,Florida International,CUSA,12,3,48,16.0,0,4.0,7,80,11.4,0,6.7,10,128,12.8,0,,ross-fournet-1
790,Ryan Williams*,Alabama,SEC,13,4,48,12.0,2,3.7,48,865,18.0,8,66.5,52,913,17.6,10,,ryan-williams-11
791,Anthony Frias II,UCLA,Big Ten,11,15,47,3.1,0,4.3,2,18,9.0,0,1.6,17,65,3.8,0,,anthony-frias-ii-1
792,Caden Williams*,Liberty,CUSA,3,14,47,3.4,0,15.7,0,0,,0,0.0,14,47,3.4,0,,caden-williams-4
793,Cam Crooks,Tulsa,American,2,2,47,23.5,0,23.5,0,0,,0,0.0,2,47,23.5,0,,cam-crooks-1
794,Grant Wilson,Old Dominion,Sun Belt,3,28,47,1.7,1,15.7,0,0,,0,0.0,28,47,1.7,1,,grant-wilson-1
795,Isaac Wilson,Utah,Big 12,9,61,47,0.8,0,5.2,0,0,,0,0.0,61,47,0.8,0,,isaac-wilson-1
796,Jeremiah Smith*,Ohio State,Big Ten,16,6,47,7.8,1,2.9,76,1315,17.3,15,82.2,82,1362,16.6,16,,jeremiah-smith-2
797,Keylen Adams*,Virginia Tech,ACC,3,1,47,47.0,0,15.7,1,14,14.0,0,4.7,2,61,30.5,0,,keylen-adams-1
798,Matthew Caldwell,Troy,Sun Belt,10,48,47,1.0,5,4.7,1,29,29.0,0,2.9,49,76,1.6,5,,matthew-caldwell-1
799,Amir Hassan*,Navy,American,13,14,46,3.3,0,3.5,3,34,11.3,0,2.6,17,80,4.7,0,,amir-hassan-1
800,DeJuan Williams,Maryland,Big Ten,3,8,46,5.8,1,15.3,1,2,2.0,0,0.7,9,48,5.3,1,,dejuan-williams-1
801,Israel Carter*,South Florida,American,4,10,46,4.6,0,11.5,0,0,,0,0.0,10,46,4.6,0,,israel-carter-1
802,Jake Garcia*,East Carolina,American,6,40,46,1.2,2,7.7,0,0,,0,0.0,40,46,1.2,2,,jake-garcia-1
803,Trey Sanders*,Texas Christian,Big 12,10,13,46,3.5,0,4.6,0,0,,0,0.0,13,46,3.5,0,,trey-sanders-2
804,Tychaun Chapman,Marshall,Sun Belt,12,8,46,5.8,2,3.8,17,146,8.6,1,12.2,25,192,7.7,3,,tychaun-chapman-1
805,Dexter Williams II*,Georgia Southern,Sun Belt,5,13,45,3.5,1,9.0,0,0,,0,0.0,13,45,3.5,1,,dexter-williams-ii-1
806,Jayden Maiava*,USC,Big Ten,7,20,45,2.3,4,6.4,1,-3,-3.0,0,-0.4,21,42,2.0,4,,jayden-maiava-1
807,Jordan Ford,Georgia State,Sun Belt,5,15,45,3.0,0,9.0,6,62,10.3,1,12.4,21,107,5.1,1,,jordan-ford-2
808,Micah Davis*,Ole Miss,SEC,13,19,45,2.4,0,3.5,5,57,11.4,0,4.4,24,102,4.3,0,,micah-davis-1
809,PJ Hatter*,Texas State,Sun Belt,1,7,45,6.4,0,45.0,0,0,,0,0.0,7,45,6.4,0,,pj-hatter-1
810,Adam Randall,Clemson,ACC,12,4,44,11.0,0,3.7,16,155,9.7,2,12.9,20,199,10.0,2,,adam-randall-1
811,Charlie Vincent,Utah,Big 12,12,14,44,3.1,0,3.7,2,9,4.5,0,0.8,16,53,3.3,0,,charlie-vincent-1
812,Gabriel Benyard,Kennesaw State,CUSA,7,4,44,11.0,0,6.3,19,162,8.5,0,23.1,23,206,9.0,0,,gabriel-benyard-1
813,Josiah Martin*,California,ACC,7,5,44,8.8,1,6.3,12,112,9.3,0,16.0,17,156,9.2,1,,josiah-martin-1
814,Rocko Griffin*,UTSA,American,4,17,44,2.6,0,11.0,3,16,5.3,0,4.0,20,60,3.0,0,,rocko-griffin-1
815,Ryan Butler,Stanford,ACC,8,7,44,6.3,0,5.5,2,11,5.5,0,1.4,9,55,6.1,0,,ryan-butler-1
816,Ty Simpson*,Alabama,SEC,6,8,44,5.5,1,7.3,0,0,,0,0.0,8,44,5.5,1,,ty-simpson-1
817,Cameron Bates,Boise State,MWC,13,4,43,10.8,1,3.3,9,67,7.4,0,5.2,13,110,8.5,1,,cameron-bates-1
818,Chris Bell*,Louisville,ACC,13,2,43,21.5,0,3.3,43,737,17.1,4,56.7,45,780,17.3,4,,chris-bell-2
819,Chris Tyree,Virginia,ACC,10,11,43,3.9,0,4.3,24,136,5.7,0,13.6,35,179,5.1,0,,chris-tyree-1
820,Dylan Rizk,UCF,Big 12,6,29,43,1.5,0,7.2,0,0,,0,0.0,29,43,1.5,0,,dylan-rizk-1
821,Jaylan Knighton,SMU,ACC,2,12,43,3.6,0,21.5,4,42,10.5,0,21.0,16,85,5.3,0,,jaylan-knighton-1
822,Jordan Lowe,Kent State,MAC,6,15,43,2.9,0,7.2,0,0,,0,0.0,15,43,2.9,0,,jordan-lowe-2
823,Parker Kingston*,BYU,Big 12,13,6,43,7.2,0,3.3,13,196,15.1,1,15.1,19,239,12.6,1,,parker-kingston-1
824,TJ Pride,New Mexico State,CUSA,12,5,43,8.6,0,3.6,34,374,11.0,2,31.2,39,417,10.7,2,,tj-pride-1
825,Cole Ballard,Kansas,Big 12,3,5,42,8.4,0,14.0,0,0,,0,0.0,5,42,8.4,0,,cole-ballard-1
826,Jayce Brown*,Kansas State,Big 12,13,3,42,14.0,0,3.2,47,823,17.5,5,63.3,50,865,17.3,5,,jayce-brown-1
827,Jaylon Armstead,San Diego State,MWC,3,13,42,3.2,0,14.0,1,6,6.0,0,2.0,14,48,3.4,0,,jaylon-armstead-1
828,Juelz Goff*,Pitt,ACC,3,17,42,2.5,0,14.0,6,53,8.8,0,17.7,23,95,4.1,0,,juelz-goff-1
829,Raleek Brown,Arizona State,Big 12,2,9,42,4.7,0,21.0,3,6,2.0,0,3.0,12,48,4.0,0,,raleek-brown-1
830,Creed Whittemore,Mississippi State,SEC,4,1,41,41.0,1,10.3,4,65,16.3,0,16.3,5,106,21.2,1,,creed-whittemore-1
831,Damian Henderson*,Colorado State,MWC,3,9,41,4.6,0,13.7,2,13,6.5,0,4.3,11,54,4.9,0,,damian-henderson-1
832,Gabe Ervin Jr.*,Nebraska,Big Ten,8,14,41,2.9,2,5.1,0,0,,0,0.0,14,41,2.9,2,,gabe-ervin-jr-1
833,Tae Meadows,Troy,Sun Belt,8,3,41,13.7,0,5.1,0,0,,0,0.0,3,41,13.7,0,,tae-meadows-1
834,Ayo Adeyi*,James Madison,Sun Belt,2,20,40,2.0,1,20.0,0,0,,0,0.0,20,40,2.0,1,,ayo-adeyi-1
835,Cam'Ron Valdez*,Texas Tech,Big 12,2,9,40,4.4,0,20.0,1,1,1.0,0,0.5,10,41,4.1,0,,camron-valdez-1
836,Dylan Paine*,Washington State,Ind,5,9,40,4.4,2,8.0,0,0,,0,0.0,9,40,4.4,2,,dylan-paine-1
837,Jared Brown*,South Carolina,SEC,9,6,40,6.7,0,4.4,15,244,16.3,1,27.1,21,284,13.5,1,,jared-brown-2
838,Ja'Varrius Johnson,UCF,Big 12,9,4,40,10.0,0,4.4,10,62,6.2,0,6.9,14,102,7.3,0,,javarrius-johnson-1
839,Justin Stevenson,Wyoming,MWC,12,5,40,8.0,0,3.3,17,204,12.0,3,17.0,22,244,11.1,3,,justin-stevenson-1
840,Kobie Campbell,Rice,American,12,1,40,40.0,0,3.3,32,372,11.6,1,31.0,33,412,12.5,1,,kobie-campbell-1
841,Nate McCollum*,North Carolina,ACC,10,5,40,8.0,1,4.0,24,274,11.4,0,27.4,29,314,10.8,1,,nate-mccollum-1
842,Charlie Spegal,Ball State,MAC,12,12,39,3.3,0,3.3,0,0,,0,0.0,12,39,3.3,0,,charlie-spegal-1
843,Henry Belvin IV*,Duke,ACC,4,11,39,3.5,0,9.8,0,0,,0,0.0,11,39,3.5,0,,henry-belvin-iv-1
844,Mac Dalena*,Fresno State,MWC,13,5,39,7.8,0,3.0,64,1065,16.6,8,81.9,69,1104,16.0,8,,mac-dalena-1
845,Te'Rai Powell,Massachusetts,Ind,12,1,39,39.0,0,3.3,0,0,,0,0.0,1,39,39.0,0,,terai-powell-1
846,Timmy Mcclain*,Arkansas State,Sun Belt,4,19,39,2.1,1,9.8,0,0,,0,0.0,19,39,2.1,1,,timmy-mcclain-1
847,Tyler Mason*,Virginia Tech,ACC,2,10,39,3.9,0,19.5,1,0,0.0,0,0.0,11,39,3.5,0,,tyler-mason-2
848,Yulkeith Brown*,Tulane,American,14,8,39,4.9,1,2.8,35,470,13.4,4,33.6,43,509,11.8,5,,yulkeith-brown-1
849,DeAngelo Irvin Jr.*,Nevada-Las Vegas,MWC,13,7,38,5.4,0,2.9,5,32,6.4,0,2.5,12,70,5.8,0,,deangelo-irvin-jr-1
850,Hunter Barnes,Tennessee,SEC,4,7,38,5.4,0,9.5,0,0,,0,0.0,7,38,5.4,0,,hunter-barnes-1
851,Jaylin Noel*,Iowa State,Big 12,14,9,38,4.2,0,2.7,80,1194,14.9,8,85.3,89,1232,13.8,8,,jaylin-noel-1
852,David Clerk*,Army,American,5,4,37,9.3,0,7.4,1,4,4.0,0,0.8,5,41,8.2,0,,david-clerk-1
853,Easton Messer*,Western Kentucky,CUSA,14,9,37,4.1,0,2.6,55,793,14.4,4,56.6,64,830,13.0,4,,easton-messer-1
854,Germie Bernard*,Alabama,SEC,13,4,37,9.3,1,2.8,50,794,15.9,2,61.1,54,831,15.4,3,,germie-bernard-1
855,Javance Tupou'ata-Johnson,San Diego State,MWC,4,18,37,2.1,0,9.3,0,0,,0,0.0,18,37,2.1,0,,javance-tupouata-johnson-1
856,Josh Dallas*,Georgia Southern,Sun Belt,13,4,37,9.3,1,2.8,46,614,13.3,6,47.2,50,651,13.0,7,,josh-dallas-1
857,Marcus Bellon,Nevada,MWC,13,9,37,4.1,0,2.8,39,522,13.4,4,40.2,48,559,11.6,4,,marcus-bellon-1
858,Blake Shapen,Mississippi State,SEC,4,34,36,1.1,2,9.0,0,0,,0,0.0,34,36,1.1,2,,blake-shapen-1
859,Jordan Burch,Oregon,Big Ten,10,1,36,36.0,0,3.6,0,0,,0,0.0,1,36,36.0,0,,jordan-burch-1
860,Kevin Concepcion*,North Carolina State,ACC,12,19,36,1.9,2,3.0,53,460,8.7,6,38.3,72,496,6.9,8,,kevin-concepcion-2
861,Tanner Arkin*,Illinois,Big Ten,13,1,36,36.0,0,2.8,16,111,6.9,3,8.5,17,147,8.6,3,,tanner-arkin-1
862,Tyrell Reed Jr.*,Arkansas,SEC,3,6,36,6.0,1,12.0,1,47,47.0,1,15.7,7,83,11.9,2,,tyrell-reed-jr-1
863,Andon Thomas*,Army,American,14,1,35,35.0,0,2.5,0,0,,0,0.0,1,35,35.0,0,,andon-thomas-1
864,Devonte Ross,Troy,Sun Belt,12,9,35,3.9,0,2.9,76,1043,13.7,11,86.9,85,1078,12.7,11,,devonte-ross-2
865,Dylan Lee*,Iowa State,Big 12,2,11,35,3.2,1,17.5,1,7,7.0,0,3.5,12,42,3.5,1,,dylan-lee-2
866,Jay Harris,Oregon,Big Ten,4,10,35,3.5,1,8.8,1,2,2.0,0,0.5,11,37,3.4,1,,jay-harris-2
867,Lucky Sutton,San Diego State,MWC,4,5,35,7.0,0,8.8,0,0,,0,0.0,5,35,7.0,0,,lucky-sutton-1
868,Matthew Rhodes*,Army,American,14,2,35,17.5,1,2.5,0,0,,0,0.0,2,35,17.5,1,,matthew-rhodes-2
869,Max White*,Iowa,Big Ten,13,6,35,5.8,0,2.7,0,0,,0,0.0,6,35,5.8,0,,max-white-1
870,Rodney Hammond Jr.*,Pitt,ACC,4,12,35,2.9,0,8.8,2,10,5.0,0,2.5,14,45,3.2,0,,rodney-hammond-jr-1
871,Spencer Petras,Utah State,MWC,9,36,35,1.0,1,3.9,0,0,,0,0.0,36,35,1.0,1,,spencer-petras-1
872,James Tucker*,Coastal Carolina,Sun Belt,13,3,34,11.3,0,2.6,34,579,17.0,6,44.5,37,613,16.6,6,,james-tucker-4
873,Jaylen Anderson*,West Virginia,Big 12,9,9,34,3.8,0,3.8,1,9,9.0,0,1.0,10,43,4.3,0,,jaylen-anderson-2
874,Luke Bottari,Utah,Big 12,3,9,34,3.8,0,11.3,0,0,,0,0.0,9,34,3.8,0,,luke-bottari-1
875,Michael Mathison*,Western Kentucky,CUSA,13,7,34,4.9,1,2.6,13,143,11.0,2,11.0,20,177,8.9,3,,michael-mathison-1
876,Parker Jenkins,Houston,Big 12,6,17,34,2.0,0,5.7,3,7,2.3,0,1.2,20,41,2.1,0,,parker-jenkins-1
877,Rod Gainey Jr.,Charlotte,American,4,10,34,3.4,0,8.5,1,13,13.0,0,3.3,11,47,4.3,0,,rod-gainey-jr-1
878,Terrell Washington Jr.*,Iowa,Big Ten,11,12,34,2.8,0,3.1,6,33,5.5,1,3.0,18,67,3.7,1,,terrell-washington-jr-1
879,Cameron Rising,Utah,Big 12,3,8,33,4.1,0,11.0,0,0,,0,0.0,8,33,4.1,0,,cameron-rising-1
880,C.J. Stokes,Charlotte,American,3,7,33,4.7,1,11.0,1,6,6.0,0,2.0,8,39,4.9,1,,cj-stokes-1
881,Demarcus Jones*,North Carolina State,ACC,13,6,33,5.5,1,2.5,1,14,14.0,0,1.1,7,47,6.7,1,,demarcus-jones-1
882,Dwight Phillips Jr.,Georgia,SEC,6,6,33,5.5,1,5.5,2,24,12.0,0,4.0,8,57,7.1,1,,dwight-phillips-jr-1
883,Eddie Lee Marburger*,UTSA,American,7,9,33,3.7,0,4.7,0,0,,0,0.0,9,33,3.7,0,,eddie-lee-marburger-1
884,Emeka Egbuka*,Ohio State,Big Ten,16,8,33,4.1,0,2.1,81,1011,12.5,10,63.2,89,1044,11.7,10,,emeka-egbuka-1
885,Harrison Barker,UAB,American,4,5,33,6.6,0,8.3,0,0,,0,0.0,5,33,6.6,0,,harrison-barker-1
886,Jason Brown Jr.,Arizona State,Big 12,1,4,33,8.3,0,33.0,0,0,,0,0.0,4,33,8.3,0,,jason-brown-jr-1
887,Jaylen Johnson*,South Florida,American,1,6,33,5.5,0,33.0,0,0,,0,0.0,6,33,5.5,0,,jaylen-johnson-6
888,Kaden Wetjen*,Iowa,Big Ten,13,4,33,8.3,0,2.5,3,46,15.3,0,3.5,7,79,11.3,0,,kaden-wetjen-1
889,Anthony Rubio*,Florida,SEC,1,6,32,5.3,1,32.0,0,0,,0,0.0,6,32,5.3,1,,anthony-rubio-1
890,Deion Burks*,Oklahoma,SEC,5,5,32,6.4,0,6.4,31,245,7.9,3,49.0,36,277,7.7,3,,deion-burks-1
891,Deston Hawkins,Nevada,MWC,12,6,32,5.3,0,2.7,7,33,4.7,0,2.8,13,65,5.0,0,,deston-hawkins-2
892,John Montague*,Boston College,ACC,9,3,32,10.7,1,3.6,5,26,5.2,0,2.9,8,58,7.3,1,,john-montague-1
893,Johnny Thompson Jr.,Kansas,Big 12,2,5,32,6.4,0,16.0,0,0,,0,0.0,5,32,6.4,0,,johnny-thompson-jr-1
894,Luke Reynolds*,Penn State,Big Ten,16,1,32,32.0,0,2.0,9,111,12.3,1,6.9,10,143,14.3,1,,luke-reynolds-1
895,Quinton Martin*,Penn State,Big Ten,6,13,32,2.5,0,5.3,3,18,6.0,0,3.0,16,50,3.1,0,,quinton-martin-1
896,Semaj Morgan*,Michigan,Big Ten,11,6,32,5.3,0,2.9,27,139,5.1,1,12.6,33,171,5.2,1,,semaj-morgan-1
897,Anthony Brown,Kentucky,SEC,12,7,31,4.4,0,2.6,5,77,15.4,2,6.4,12,108,9.0,2,,anthony-brown-15
898,Bennett Galloway,Louisiana-Monroe,Sun Belt,8,9,31,3.4,0,3.9,0,0,,0,0.0,9,31,3.4,0,,bennett-galloway-1
899,Chris Johnson Jr.*,Miami (FL),ACC,12,6,31,5.2,0,2.6,8,72,9.0,2,6.0,14,103,7.4,2,,chris-johnson-jr-1
900,Chris Parson,Mississippi State,SEC,4,8,31,3.9,0,7.8,0,0,,0,0.0,8,31,3.9,0,,chris-parson-1
901,Jalin Conyers*,Texas Tech,Big 12,13,8,31,3.9,2,2.4,30,320,10.7,5,24.6,38,351,9.2,7,,jalin-conyers-1
902,Jamari Hawkins*,Memphis,American,12,4,31,7.8,0,2.6,3,24,8.0,0,2.0,7,55,7.9,0,,jamari-hawkins-1
903,Kyle Morlock,Florida State,ACC,12,1,31,31.0,0,2.6,13,149,11.5,0,12.4,14,180,12.9,0,,kyle-morlock-1
904,Eamonn Dennis*,Ohio,MAC,11,5,30,6.0,0,2.7,3,26,8.7,0,2.4,8,56,7.0,0,,eamonn-dennis-1
905,Elija Lofton*,Miami (FL),ACC,13,2,30,15.0,1,2.3,9,150,16.7,1,11.5,11,180,16.4,2,,elija-lofton-1
906,Gerry Bohanon*,BYU,Big 12,4,7,30,4.3,0,7.5,0,0,,0,0.0,7,30,4.3,0,,gerry-bohanon-1
907,Jojo Earle*,Texas Christian,Big 12,4,3,30,10.0,0,7.5,7,37,5.3,1,9.3,10,67,6.7,1,,jojo-earle-1
908,Kendrick Law*,Alabama,SEC,10,8,30,3.8,0,3.0,10,105,10.5,1,10.5,18,135,7.5,1,,kendrick-law-1
909,Kevin Riley*,Alabama,SEC,2,10,30,3.0,0,15.0,2,9,4.5,0,4.5,12,39,3.3,0,,kevin-riley-2
910,Marquez Dortch,Troy,Sun Belt,10,3,30,10.0,0,3.0,2,-2,-1.0,1,-0.2,5,28,5.6,1,,marquez-dortch-1
911,Zach Hrbacek*,Sam Houston,CUSA,13,12,30,2.5,0,2.3,2,5,2.5,0,0.4,14,35,2.5,0,,zach-hrbacek-1
912,Alexander Diggs,Kennesaw State,CUSA,6,9,29,3.2,0,4.8,0,0,,0,0.0,9,29,3.2,0,,alexander-diggs-1
913,Cameron Friel*,Nevada-Las Vegas,MWC,5,8,29,3.6,2,5.8,0,0,,0,0.0,8,29,3.6,2,,cameron-friel-1
914,Dan Villari*,Syracuse,ACC,12,12,29,2.4,1,2.4,6,57,9.5,0,4.8,18,86,4.8,1,,dan-villari-1
915,Ja'koby Banks*,Memphis,American,9,8,29,3.6,0,3.2,3,1,0.3,0,0.1,11,30,2.7,0,,jakoby-banks-1
916,Mikey Matthews*,California,ACC,13,7,29,4.1,0,2.2,32,272,8.5,1,20.9,39,301,7.7,1,,mikey-matthews-1
917,Nick Rempert*,North Texas,American,12,2,29,14.5,0,2.4,11,127,11.5,1,10.6,13,156,12.0,1,,nick-rempert-2
918,P.J. Prioleau*,Virginia Tech,ACC,6,7,29,4.1,0,4.8,0,0,,0,0.0,7,29,4.1,0,,pj-prioleau-1
919,Ron Wiggins*,Jacksonville State,CUSA,2,6,29,4.8,0,14.5,1,5,5.0,0,2.5,7,34,4.9,0,,ron-wiggins-1
920,Cale Hellums*,Army,American,3,7,28,4.0,0,9.3,0,0,,0,0.0,7,28,4.0,0,,cale-hellums-1
921,Coleman Bennett,Rice,American,4,2,28,14.0,1,7.0,0,0,,0,0.0,2,28,14.0,1,,coleman-bennett-1
922,Devin McCuin*,UTSA,American,8,3,28,9.3,0,3.5,45,424,9.4,5,53.0,48,452,9.4,5,,devin-mccuin-1
923,Forrest Brock,Temple,American,3,28,28,1.0,1,9.3,0,0,,0,0.0,28,28,1.0,1,,forrest-brock-1
924,Frederick Moore*,Michigan,Big Ten,13,5,28,5.6,0,2.2,11,128,11.6,1,9.8,16,156,9.8,1,,frederick-moore-2
925,Jonathan Brady*,California,ACC,13,5,28,5.6,0,2.2,36,386,10.7,3,29.7,41,414,10.1,3,,jonathan-brady-1
926,Kris Hutson*,Washington State,Ind,12,4,28,7.0,1,2.3,54,683,12.6,2,56.9,58,711,12.3,3,,kris-hutson-1
927,Lawrence Arnold,Kansas,Big 12,12,2,28,14.0,1,2.3,26,360,13.8,1,30.0,28,388,13.9,2,,lawrence-arnold-2
928,Rico Scott*,Alabama,SEC,4,1,28,28.0,0,7.0,5,60,12.0,1,15.0,6,88,14.7,1,,rico-scott-1
929,Trace Campbell,UAB,American,6,5,28,5.6,0,4.7,2,-5,-2.5,0,-0.8,7,23,3.3,0,,trace-campbell-2
930,Tyler Douglas,Temple,American,3,13,28,2.2,0,9.3,0,0,,0,0.0,13,28,2.2,0,,tyler-douglas-1
931,Tyler Stewart,Temple,American,8,3,28,9.3,0,3.5,5,60,12.0,0,7.5,8,88,11.0,0,,tyler-stewart-2
932,Zevi Eckhaus*,Washington State,Ind,3,11,28,2.5,1,9.3,0,0,,0,0.0,11,28,2.5,1,,zevi-eckhaus-1
933,Braylin Presley,Tulsa,American,11,3,27,9.0,1,2.5,9,73,8.1,0,6.6,12,100,8.3,1,,braylin-presley-1
934,Cash Jones,Georgia,SEC,14,14,27,1.9,1,1.9,24,275,11.5,4,19.6,38,302,7.9,5,,cash-jones-1
935,DJ Riles,Georgia State,Sun Belt,12,2,27,13.5,0,2.3,20,172,8.6,0,14.3,22,199,9.0,0,,dj-riles-1
936,Jalen Macon*,Northern Illinois,MAC,1,5,27,5.4,1,27.0,0,0,,0,0.0,5,27,5.4,1,,jalen-macon-1
937,Jamaal Bell*,Baylor,Big 12,13,5,27,5.4,0,2.1,2,6,3.0,0,0.5,7,33,4.7,0,,jamaal-bell-1
938,Jayden Thomas*,Notre Dame,Ind,16,3,27,9.0,0,1.7,18,167,9.3,2,10.4,21,194,9.2,2,,jayden-thomas-1
939,Kam Thomas,UTEP,CUSA,9,13,27,2.1,0,3.0,47,532,11.3,2,59.1,60,559,9.3,2,,kam-thomas-1
940,Keshawn King*,Western Michigan,MAC,2,9,27,3.0,0,13.5,0,0,,0,0.0,9,27,3.0,0,,keshawn-king-1
941,Ke'Shawn Williams,Indiana,Big Ten,13,2,27,13.5,0,2.1,39,448,11.5,5,34.5,41,475,11.6,5,,keshawn-williams-2
942,Miles Stewart*,Army,American,14,4,27,6.8,0,1.9,3,26,8.7,1,1.9,7,53,7.6,1,,miles-stewart-1
943,Terry Lockett Jr.,Eastern Michigan,MAC,12,5,27,5.4,0,2.3,46,660,14.3,5,55.0,51,687,13.5,5,,terry-lockett-jr-1
944,Brant Kuithe,Utah,Big 12,9,8,26,3.3,2,2.9,35,505,14.4,6,56.1,43,531,12.3,8,,brant-kuithe-1
945,Coleman Owen*,Ohio,MAC,14,2,26,13.0,1,1.9,78,1245,16.0,8,88.9,80,1271,15.9,9,,coleman-owen-1
946,Jabre Barber*,Texas A&M,SEC,12,8,26,3.3,0,2.2,38,381,10.0,2,31.8,46,407,8.8,2,,jabre-barber-1
947,Kenny Johnson*,Pitt,ACC,13,6,26,4.3,0,2.0,46,537,11.7,3,41.3,52,563,10.8,3,,kenny-johnson-3
948,Palmer Domschke*,Western Michigan,MAC,3,1,26,26.0,0,8.7,0,0,,0,0.0,1,26,26.0,0,,palmer-domschke-1
949,Patrick Rea*,Louisiana Tech,CUSA,13,1,26,26.0,0,2.0,0,0,,0,0.0,1,26,26.0,0,,patrick-rea-1
950,Shaborne Demps,Florida International,CUSA,7,7,26,3.7,0,3.7,1,14,14.0,0,2.0,8,40,5.0,0,,shaborne-demps-1
951,Trevion Cooley*,Georgia Tech,ACC,2,6,26,4.3,0,13.0,1,4,4.0,0,2.0,7,30,4.3,0,,trevion-cooley-1
952,Tyler Van Dyke,Wisconsin,Big Ten,3,15,26,1.7,1,8.7,0,0,,0,0.0,15,26,1.7,1,,tyler-van-dyke-1
953,Velton Gardner*,Texas,SEC,2,8,26,3.3,0,13.0,0,0,,0,0.0,8,26,3.3,0,,velton-gardner-1
954,Chayden Peery,Florida International,CUSA,1,10,25,2.5,0,25.0,0,0,,0,0.0,10,25,2.5,0,,chayden-peery-1
955,Dalen Cobb*,Georgia Southern,Sun Belt,13,8,25,3.1,0,1.9,52,599,11.5,4,46.1,60,624,10.4,4,,dalen-cobb-1
956,Ky Woods,Nevada,MWC,13,7,25,3.6,0,1.9,3,8,2.7,0,0.6,10,33,3.3,0,,ky-woods-1
957,Matthew Fuller*,South Carolina,SEC,2,8,25,3.1,0,12.5,0,0,,0,0.0,8,25,3.1,0,,matthew-fuller-1
958,Moses Gray Jr.,Marshall,Sun Belt,4,7,25,3.6,0,6.3,0,0,,0,0.0,7,25,3.6,0,,moses-gray-jr-1
959,Nate Palmer*,Texas Christian,Big 12,2,11,25,2.3,0,12.5,0,0,,0,0.0,11,25,2.3,0,,nate-palmer-2
960,Nate Yarnell*,Pitt,ACC,9,35,25,0.7,0,2.8,1,-6,-6.0,0,-0.7,36,19,0.5,0,,nate-yarnell-1
961,Ajani Sheppard*,Rutgers,Big Ten,4,3,24,8.0,0,6.0,0,0,,0,0.0,3,24,8.0,0,,ajani-sheppard-1
962,Corey Wren,UTEP,CUSA,8,10,24,2.4,0,3.0,1,6,6.0,0,0.8,11,30,2.7,0,,corey-wren-1
963,Dean Patterson,Florida International,CUSA,12,5,24,4.8,2,2.0,50,685,13.7,7,57.1,55,709,12.9,9,,dean-patterson-1
964,Harry Stewart III,Kansas,Big 12,2,7,24,3.4,0,12.0,0,0,,0,0.0,7,24,3.4,0,,harry-stewart-iii-1
965,Jarod Bowie*,Jacksonville State,CUSA,14,3,24,8.0,0,1.7,13,207,15.9,0,14.8,16,231,14.4,0,,jarod-bowie-1
966,Jayden Mines*,James Madison,Sun Belt,12,1,24,24.0,0,2.0,0,0,,0,0.0,1,24,24.0,0,,jayden-mines-1
967,Julian Sayin*,Ohio State,Big Ten,4,2,24,12.0,0,6.0,0,0,,0,0.0,2,24,12.0,0,,julian-sayin-1
968,Justin Jones,Auburn,SEC,12,1,24,24.0,0,2.0,0,0,,0,0.0,1,24,24.0,0,,justin-jones-6
969,Kenyon Sadiq,Oregon,Big Ten,14,5,24,4.8,0,1.7,24,308,12.8,2,22.0,29,332,11.4,2,,kenyon-sadiq-1
970,Preston Stone,SMU,ACC,7,11,24,2.2,0,3.4,0,0,,0,0.0,11,24,2.2,0,,preston-stone-1
971,Solomon Davis,Central Michigan,MAC,12,3,24,8.0,0,2.0,19,350,18.4,2,29.2,22,374,17.0,2,,solomon-davis-2
972,Ashten Emory,UTEP,CUSA,3,6,23,3.8,0,7.7,2,12,6.0,0,4.0,8,35,4.4,0,,ashten-emory-1
973,Isaiah Bryant*,Navy,American,13,7,23,3.3,0,1.8,1,5,5.0,0,0.4,8,28,3.5,0,,isaiah-bryant-2
974,Nick Marsh,Michigan State,Big Ten,11,4,23,5.8,0,2.1,41,649,15.8,3,59.0,45,672,14.9,3,,nick-marsh-3
975,Omar Cooper Jr.,Indiana,Big Ten,13,2,23,11.5,1,1.8,28,594,21.2,7,45.7,30,617,20.6,8,,omar-cooper-jr-1
976,Oran Singleton,Eastern Michigan,MAC,12,6,23,3.8,0,1.9,64,639,10.0,2,53.3,70,662,9.5,2,,oran-singleton-1
977,Ryan Niblett*,Texas,SEC,15,8,23,2.9,1,1.5,3,24,8.0,0,1.6,11,47,4.3,1,,ryan-niblett-1
978,Tai Felton,Maryland,Big Ten,12,2,23,11.5,0,1.9,96,1124,11.7,9,93.7,98,1147,11.7,9,,tai-felton-1
979,Bryson Graves*,Coastal Carolina,Sun Belt,12,4,22,5.5,0,1.8,27,327,12.1,2,27.3,31,349,11.3,2,,bryson-graves-1
980,Chris Carpenter*,UTSA,American,12,4,22,5.5,0,1.8,39,479,12.3,1,39.9,43,501,11.7,1,,chris-carpenter-2
981,Jacob Godfrey,Louisiana-Monroe,Sun Belt,12,1,22,22.0,0,1.8,24,265,11.0,2,22.1,25,287,11.5,2,,jacob-godfrey-1
982,Jake Merklinger,Tennessee,SEC,2,7,22,3.1,0,11.0,0,0,,0,0.0,7,22,3.1,0,,jake-merklinger-1
983,Malcolm Gillie,Ball State,MAC,11,4,22,5.5,0,2.0,19,267,14.1,2,24.3,23,289,12.6,2,,malcolm-gillie-1
984,Mark Scott*,Buffalo,MAC,9,6,22,3.7,0,2.4,1,-1,-1.0,0,-0.1,7,21,3.0,0,,mark-scott-3
985,Mike Sharpe II*,Arkansas State,Sun Belt,11,4,22,5.5,0,2.0,1,5,5.0,0,0.5,5,27,5.4,0,,mike-sharpe-ii-1
986,Quentin Skinner,Kansas,Big 12,12,3,22,7.3,0,1.8,25,557,22.3,4,46.4,28,579,20.7,4,,quentin-skinner-2
987,Quincy Skinner Jr.*,Vanderbilt,SEC,13,1,22,22.0,0,1.7,29,367,12.7,3,28.2,30,389,13.0,3,,quincy-skinner-jr-1
988,Sam Vander Haar*,BYU,Big 12,13,1,22,22.0,0,1.7,0,0,,0,0.0,1,22,22.0,0,,sam-vander-haar-1
989,Stevo Klotz*,Iowa State,Big 12,13,2,22,11.0,0,1.7,8,89,11.1,1,6.8,10,111,11.1,1,,stevo-klotz-1
990,Traeshon Holden,Oregon,Big Ten,13,2,22,11.0,0,1.7,45,718,16.0,5,55.2,47,740,15.7,5,,traeshon-holden-1
991,Amari Jones,Florida International,CUSA,5,12,21,1.8,0,4.2,0,0,,0,0.0,12,21,1.8,0,,amari-jones-1
992,Barry Jackson Jr.,Cincinnati,Big 12,10,7,21,3.0,0,2.1,3,22,7.3,0,2.2,10,43,4.3,0,,barry-jackson-jr-1
993,Caullin Lacy*,Louisville,ACC,5,5,21,4.2,1,4.2,18,196,10.9,1,39.2,23,217,9.4,2,,caullin-lacy-1
994,Chase Roberts*,BYU,Big 12,13,5,21,4.2,0,1.6,52,854,16.4,4,65.7,57,875,15.4,4,,chase-roberts-2
995,Dakota Williams*,Louisiana Tech,CUSA,5,3,21,7.0,0,4.2,3,25,8.3,0,5.0,6,46,7.7,0,,dakota-williams-1
996,Dontae Fleming*,Tulane,American,14,3,21,7.0,0,1.5,31,598,19.3,1,42.7,34,619,18.2,1,,dontae-fleming-1
997,Drew Pyne*,Missouri,SEC,6,15,21,1.4,0,3.5,0,0,,0,0.0,15,21,1.4,0,,drew-pyne-1
998,Iverson Celestine*,South Alabama,Sun Belt,13,6,21,3.5,1,1.6,2,19,9.5,0,1.5,8,40,5.0,1,,iverson-celestine-1
999,Jake Reichle,Oregon State,Ind,12,6,21,3.5,1,1.8,1,9,9.0,0,0.8,7,30,4.3,1,,jake-reichle-1
1000,Leshon Williams*,Iowa,Big Ten,3,11,21,1.9,0,7.0,4,26,6.5,0,8.7,15,47,3.1,0,,leshon-williams-1
1001,Makhi Frazier,Michigan State,Big Ten,9,7,21,3.0,0,2.3,1,12,12.0,0,1.3,8,33,4.1,0,,makhi-frazier-1
1002,Qua'Vez Humphreys*,Sam Houston,CUSA,13,3,21,7.0,0,1.6,20,385,19.3,4,29.6,23,406,17.7,4,,quavez-humphreys-1
1003,RJ Martinez*,Texas State,Sun Belt,4,9,21,2.3,0,5.3,0,0,,0,0.0,9,21,2.3,0,,rj-martinez-1
1004,Brandon Tullis,Michigan State,Big Ten,8,7,20,2.9,0,2.5,0,0,,0,0.0,7,20,2.9,0,,brandon-tullis-1
1005,Chrishon McCray,Kent State,MAC,11,3,20,6.7,0,1.8,40,705,17.6,9,64.1,43,725,16.9,9,,chrishon-mccray-1
1006,Cookie Desiderio,Massachusetts,Ind,2,8,20,2.5,0,10.0,1,2,2.0,0,1.0,9,22,2.4,0,,cookie-desiderio-1
1007,Devin Bale*,Arkansas,SEC,13,2,20,10.0,0,1.5,0,0,,0,0.0,2,20,10.0,0,,devin-bale-1
1008,Drew Devillier,Rice,American,3,9,20,2.2,0,6.7,0,0,,0,0.0,9,20,2.2,0,,drew-devillier-1
1009,Evan Simon,Temple,American,9,87,20,0.2,3,2.2,0,0,,0,0.0,87,20,0.2,3,,evan-simon-1
1010,Jaron Glover,Michigan State,Big Ten,9,2,20,10.0,0,2.2,15,192,12.8,2,21.3,17,212,12.5,2,,jaron-glover-1
1011,Jordan Watkins*,Ole Miss,SEC,12,3,20,6.7,0,1.7,49,906,18.5,9,75.5,52,926,17.8,9,,jordan-watkins-2
1012,Joshua Dye,UTEP,CUSA,9,6,20,3.3,0,2.2,1,11,11.0,0,1.2,7,31,4.4,0,,joshua-dye-1
1013,Kamdyn Benjamin,Tulsa,American,12,5,20,4.0,0,1.7,70,822,11.7,6,68.5,75,842,11.2,6,,kamdyn-benjamin-1
1014,Kayden Luke,Arizona,Big 12,12,5,20,4.0,0,1.7,0,0,,0,0.0,5,20,4.0,0,,kayden-luke-1
1015,Tavierre Dunlap*,Michigan,Big Ten,12,1,20,20.0,1,1.7,0,0,,0,0.0,1,20,20.0,1,,tavierre-dunlap-1
1016,Tiaquelin Mims,Southern Mississippi,Sun Belt,12,4,20,5.0,0,1.7,33,383,11.6,1,31.9,37,403,10.9,1,,tiaquelin-mims-1
1017,TJ Finley*,Western Kentucky,CUSA,3,11,20,1.8,0,6.7,1,-7,-7.0,0,-2.3,12,13,1.1,0,,tj-finley-1
1018,Ashton Hayes,Nevada,MWC,11,3,19,6.3,0,1.7,1,10,10.0,0,0.9,4,29,7.3,0,,ashton-hayes-1
1019,Daniel Weems,Indiana,Big Ten,1,4,19,4.8,0,19.0,0,0,,0,0.0,4,19,4.8,0,,daniel-weems-1
1020,David Amador II*,UTSA,American,5,2,19,9.5,0,3.8,31,376,12.1,1,75.2,33,395,12.0,1,,david-amador-ii-1
1021,D'Wanyé Winfield*,Louisiana,Sun Belt,1,5,19,3.8,0,19.0,0,0,,0,0.0,5,19,3.8,0,,dwanye-winfield-1
1022,Jacob Emmers,Tulsa,American,8,2,19,9.5,0,2.4,5,80,16.0,0,10.0,7,99,14.1,0,,jacob-emmers-1
1023,Jacobe Robinson*,Boston College,ACC,2,6,19,3.2,1,9.5,0,0,,0,0.0,6,19,3.2,1,,jacobe-robinson-1
1024,Joey Labas,Central Michigan,MAC,6,21,19,0.9,0,3.2,0,0,,0,0.0,21,19,0.9,0,,joey-labas-1
1025,Jordan Nubin*,Minnesota,Big Ten,11,11,19,1.7,0,1.7,3,32,10.7,0,2.9,14,51,3.6,0,,jordan-nubin-1
1026,Kaden Cloud,Air Force,MWC,8,5,19,3.8,0,2.4,1,4,4.0,0,0.5,6,23,3.8,0,,kaden-cloud-1
1027,Lucas Borrow,Hawaii,MWC,12,1,19,19.0,0,1.6,0,0,,0,0.0,1,19,19.0,0,,lucas-borrow-1
1028,Rocco Conti,Air Force,MWC,5,8,19,2.4,0,3.8,0,0,,0,0.0,8,19,2.4,0,,rocco-conti-1
1029,Sam Adams II*,Washington,Big Ten,12,8,19,2.4,0,1.6,0,0,,0,0.0,8,19,2.4,0,,sam-adams-ii-1
1030,Stephon Johnson Jr.,Houston,Big 12,11,3,19,6.3,0,1.7,32,402,12.6,2,36.5,35,421,12.0,2,,stephon-johnson-jr-1
1031,Tyler Shough*,Louisville,ACC,12,42,19,0.5,1,1.6,0,0,,0,0.0,42,19,0.5,1,,tyler-shough-1
1032,William Watson III*,Virginia Tech,ACC,5,40,19,0.5,1,3.8,0,0,,0,0.0,40,19,0.5,1,,william-watson-iii-1
1033,Cayden Lee*,Ole Miss,SEC,13,2,18,9.0,0,1.4,57,874,15.3,2,67.2,59,892,15.1,2,,cayden-lee-1
1034,DJ Murray Jr.,Georgia State,Sun Belt,4,3,18,6.0,0,4.5,4,13,3.3,0,3.3,7,31,4.4,0,,dj-murray-jr-1
1035,Donovan Faupel,New Mexico State,CUSA,7,1,18,18.0,0,2.6,3,48,16.0,1,6.9,4,66,16.5,1,,donovan-faupel-1
1036,Duane Thomas Jr.,Charlotte,American,8,2,18,9.0,0,2.3,6,63,10.5,1,7.9,8,81,10.1,1,,duane-thomas-jr-1
1037,EJ Caminong*,California,ACC,1,10,18,1.8,0,18.0,0,0,,0,0.0,10,18,1.8,0,,ej-caminong-1
1038,Gaston Moore,Tennessee,SEC,6,3,18,6.0,0,3.0,0,0,,0,0.0,3,18,6.0,0,,gaston-moore-1
1039,Jacob Knuth*,Kansas State,Big 12,2,3,18,6.0,0,9.0,0,0,,0,0.0,3,18,6.0,0,,jacob-knuth-1
1040,Jaden Hart*,Syracuse,ACC,8,3,18,6.0,0,2.3,2,1,0.5,0,0.1,5,19,3.8,0,,jaden-hart-1
1041,Jamaal Wiley*,California,ACC,4,6,18,3.0,1,4.5,0,0,,0,0.0,6,18,3.0,1,,jamaal-wiley-1
1042,James Carpenter,Indiana,Big Ten,13,1,18,18.0,0,1.4,0,0,,0,0.0,1,18,18.0,0,,james-carpenter-2
1043,Jeremiah Webb*,South Alabama,Sun Belt,13,1,18,18.0,0,1.4,36,649,18.0,5,49.9,37,667,18.0,5,,jeremiah-webb-1
1044,Kamalu DeBlake,Hawaii,MWC,11,4,18,4.5,0,1.6,0,0,,0,0.0,4,18,4.5,0,,kamalu-deblake-1
1045,Nathan Acevedo*,Fresno State,MWC,7,2,18,9.0,0,2.6,9,65,7.2,0,9.3,11,83,7.5,0,,nathan-acevedo-1
1046,Noah Thomas*,Texas A&M,SEC,13,4,18,4.5,0,1.4,39,574,14.7,8,44.2,43,592,13.8,8,,noah-thomas-1
1047,Rickie Collins*,LSU,SEC,3,4,18,4.5,0,6.0,0,0,,0,0.0,4,18,4.5,0,,rickie-collins-1
1048,Walker White,Auburn,SEC,1,4,18,4.5,0,18.0,0,0,,0,0.0,4,18,4.5,0,,walker-white-1
1049,Alante Brown,Michigan State,Big Ten,4,3,17,5.7,0,4.3,2,20,10.0,0,5.0,5,37,7.4,0,,alante-brown-1
1050,Alton McCaskill,Arizona State,Big 12,8,7,17,2.4,0,2.1,0,0,,0,0.0,7,17,2.4,0,,alton-mccaskill-1
1051,Brody Rhodes*,Georgia Tech,ACC,1,2,17,8.5,0,17.0,0,0,,0,0.0,2,17,8.5,0,,brody-rhodes-1
1052,Dante Wright,Temple,American,9,5,17,3.4,0,1.9,61,792,13.0,6,88.0,66,809,12.3,6,,dante-wright-1
1053,Grayson Tempest,Tulsa,American,12,4,17,4.3,0,1.4,16,138,8.6,0,11.5,20,155,7.8,0,,grayson-tempest-1
1054,Harrison Bailey*,Louisville,ACC,5,2,17,8.5,0,3.4,0,0,,0,0.0,2,17,8.5,0,,harrison-bailey-1
1055,Henry Hesson*,Miami (OH),MAC,5,7,17,2.4,0,3.4,0,0,,0,0.0,7,17,2.4,0,,henry-hesson-1
1056,Hunter Andrews,Utah,Big 12,4,2,17,8.5,0,4.3,0,0,,0,0.0,2,17,8.5,0,,hunter-andrews-2
1057,Jayden Williams,Wyoming,MWC,12,1,17,17.0,0,1.4,0,0,,0,0.0,1,17,17.0,0,,jayden-williams-4
1058,Jaylen Jenkins*,Texas State,Sun Belt,2,3,17,5.7,0,8.5,0,0,,0,0.0,3,17,5.7,0,,jaylen-jenkins-1
1059,John Cannon*,South Florida,American,12,1,17,17.0,0,1.4,0,0,,0,0.0,1,17,17.0,0,,john-cannon-2
1060,Ke'Marion Baldwin*,James Madison,Sun Belt,2,6,17,2.8,0,8.5,0,0,,0,0.0,6,17,2.8,0,,kemarion-baldwin-1
1061,Luke Floriea,Kent State,MAC,12,1,17,17.0,0,1.4,44,699,15.9,7,58.3,45,716,15.9,7,,luke-floriea-1
1062,Matt Pack*,Coastal Carolina,Sun Belt,2,7,17,2.4,0,8.5,0,0,,0,0.0,7,17,2.4,0,,matt-pack-1
1063,Michael Pettway*,Jacksonville State,CUSA,14,5,17,3.4,0,1.2,25,454,18.2,3,32.4,30,471,15.7,3,,michael-pettway-1
1064,Mikey Pauley,Kansas,Big 12,1,2,17,8.5,0,17.0,0,0,,0,0.0,2,17,8.5,0,,mikey-pauley-1
1065,Noah Fifita,Arizona,Big 12,12,66,17,0.3,1,1.4,1,14,14.0,0,1.2,67,31,0.5,1,,noah-fifita-1
1066,Simeon Evans*,Sam Houston,CUSA,13,5,17,3.4,0,1.3,50,559,11.2,6,43.0,55,576,10.5,6,,simeon-evans-1
1067,Zachariah Branch*,USC,Big Ten,12,2,17,8.5,0,1.4,47,503,10.7,1,41.9,49,520,10.6,1,,zachariah-branch-1
1068,Duane Martin*,Louisville,ACC,12,3,16,5.3,1,1.3,2,17,8.5,0,1.4,5,33,6.6,1,,duane-martin-1
1069,Dylan Lonergan*,Alabama,SEC,2,1,16,16.0,0,8.0,0,0,,0,0.0,1,16,16.0,0,,dylan-lonergan-1
1070,General Booty,Louisiana-Monroe,Sun Belt,7,11,16,1.5,0,2.3,1,-7,-7.0,0,-1.0,12,9,0.8,0,,general-booty-1
1071,Giles Jackson*,Washington,Big Ten,13,4,16,4.0,1,1.2,85,893,10.5,7,68.7,89,909,10.2,8,,giles-jackson-1
1072,Jackson Gutierrez*,Navy,American,1,5,16,3.2,0,16.0,0,0,,0,0.0,5,16,3.2,0,,jackson-gutierrez-1
1073,Ja'khi Douglas,Florida State,ACC,12,5,16,3.2,0,1.3,32,519,16.2,4,43.3,37,535,14.5,4,,jakhi-douglas-1
1074,Jarvis Durr*,South Alabama,Sun Belt,1,5,16,3.2,1,16.0,0,0,,0,0.0,5,16,3.2,1,,jarvis-durr-1
1075,Joseph Hagman*,Baylor,Big 12,3,4,16,4.0,0,5.3,0,0,,0,0.0,4,16,4.0,0,,joseph-hagman-1
1076,Junior Sherrill*,Vanderbilt,SEC,13,7,16,2.3,0,1.2,29,411,14.2,3,31.6,36,427,11.9,3,,junior-sherrill-1
1077,Kajiya Hollawayne,Temple,American,11,1,16,16.0,0,1.5,9,120,13.3,0,10.9,10,136,13.6,0,,kajiya-hollawayne-2
1078,Ozarrio Smith,Louisiana-Monroe,Sun Belt,2,7,16,2.3,0,8.0,0,0,,0,0.0,7,16,2.3,0,,ozarrio-smith-1
1079,Tremonte Underwood Jr.,Florida Atlantic,American,11,2,16,8.0,0,1.5,0,0,,0,0.0,2,16,8.0,0,,tremonte-underwood-jr-1
1080,Trent Pearman,Clemson,ACC,3,3,16,5.3,0,5.3,0,0,,0,0.0,3,16,5.3,0,,trent-pearman-1
1081,Zach Williams,Utah,Big 12,10,3,16,5.3,0,1.6,10,101,10.1,0,10.1,13,117,9.0,0,,zach-williams-8
1082,Atticus Bertrams,Wisconsin,Big Ten,12,1,15,15.0,0,1.3,0,0,,0,0.0,1,15,15.0,0,,atticus-bertrams-1
1083,Aziah Johnson,Michigan State,Big Ten,12,1,15,15.0,0,1.3,16,276,17.3,2,23.0,17,291,17.1,2,,aziah-johnson-1
1084,Bobby Golden,Akron,MAC,12,2,15,7.5,0,1.3,31,446,14.4,1,37.2,33,461,14.0,1,,bobby-golden-2
1085,Bru McCoy,Tennessee,SEC,12,2,15,7.5,0,1.3,39,472,12.1,2,39.3,41,487,11.9,2,,bru-mccoy-1
1086,Dane Nauman*,Toledo,MAC,2,6,15,2.5,0,7.5,1,14,14.0,0,7.0,7,29,4.1,0,,dane-nauman-1
1087,Dane Pardridge*,Northern Illinois,MAC,12,1,15,15.0,0,1.3,20,238,11.9,3,19.8,21,253,12.0,3,,dane-pardridge-1
1088,Gage Larvadain*,South Carolina,SEC,13,2,15,7.5,0,1.2,19,223,11.7,1,17.2,21,238,11.3,1,,gage-larvadain-1
1089,Isaiah Sategna*,Arkansas,SEC,12,1,15,15.0,0,1.3,37,491,13.3,1,40.9,38,506,13.3,1,,isaiah-sategna-1
1090,James McNeil*,Buffalo,MAC,1,2,15,7.5,0,15.0,0,0,,0,0.0,2,15,7.5,0,,james-mcneil-1
1091,Jason Albritton*,Ole Miss,SEC,10,6,15,2.5,0,1.5,0,0,,0,0.0,6,15,2.5,0,,jason-albritton-1
1092,Jay Wilkerson*,Louisiana Tech,CUSA,13,1,15,15.0,0,1.2,13,262,20.2,2,20.2,14,277,19.8,2,,jay-wilkerson-3
1093,Logan Diggs*,Ole Miss,SEC,1,1,15,15.0,0,15.0,1,6,6.0,0,6.0,2,21,10.5,0,,logan-diggs-1
1094,Luby Maurice Jr.,Florida International,CUSA,10,1,15,15.0,1,1.5,0,0,,0,0.0,1,15,15.0,1,,luby-maurice-jr-1
1095,Malachi Riley,Arizona,Big 12,3,1,15,15.0,0,5.0,1,7,7.0,0,2.3,2,22,11.0,0,,malachi-riley-1
1096,Mekhi Mews,Houston,Big 12,12,4,15,3.8,0,1.3,29,253,8.7,1,21.1,33,268,8.1,1,,mekhi-mews-1
1097,Peyton Streko,Clemson,ACC,5,2,15,7.5,0,3.0,0,0,,0,0.0,2,15,7.5,0,,peyton-streko-1
1098,Reid Watkins*,Texas,SEC,1,4,15,3.8,0,15.0,0,0,,0,0.0,4,15,3.8,0,,reid-watkins-1
1099,Tad Hudson*,Coastal Carolina,Sun Belt,1,12,15,1.3,0,15.0,0,0,,0,0.0,12,15,1.3,0,,tad-hudson-1
1100,Timothy Conerly*,Nevada-Las Vegas,MWC,3,2,15,7.5,1,5.0,1,30,30.0,0,10.0,3,45,15.0,1,,timothy-conerly-1
1101,Troy Wilkey,Boise State,MWC,14,4,15,3.8,0,1.1,0,0,,0,0.0,4,15,3.8,0,,troy-wilkey-1
1102,Wade Penn,Georgia,SEC,1,3,15,5.0,0,15.0,0,0,,0,0.0,3,15,5.0,0,,wade-penn-1
1103,Antonio Molder II*,Coastal Carolina,Sun Belt,1,2,14,7.0,0,14.0,0,0,,0,0.0,2,14,7.0,0,,antonio-molder-ii-1
1104,Austin Simmons*,Ole Miss,SEC,9,5,14,2.8,0,1.6,0,0,,0,0.0,5,14,2.8,0,,austin-simmons-2
1105,BJ Hawkins Jr.,UAB,American,5,1,14,14.0,0,2.8,2,32,16.0,1,6.4,3,46,15.3,1,,bj-hawkins-jr-1
1106,Brock Lampe*,Northern Illinois,MAC,13,7,14,2.0,1,1.1,9,91,10.1,1,7.0,16,105,6.6,2,,brock-lampe-1
1107,Brock Townsend,Central Michigan,MAC,4,5,14,2.8,0,3.5,0,0,,0,0.0,5,14,2.8,0,,brock-townsend-1
1108,Destun Thomas,Kennesaw State,CUSA,5,1,14,14.0,0,2.8,1,19,19.0,0,3.8,2,33,16.5,0,,destun-thomas-1
1109,EJ Colson,UCF,Big 12,3,13,14,1.1,0,4.7,0,0,,0,0.0,13,14,1.1,0,,ej-colson-1
1110,Grady Brosterhous,Virginia,ACC,7,10,14,1.4,4,2.0,0,0,,0,0.0,10,14,1.4,4,,grady-brosterhous-1
1111,Jake Smith,Arizona State,Big 12,11,5,14,2.8,0,1.3,6,91,15.2,0,8.3,11,105,9.5,0,,jake-smith-7
1112,Ju'Juan Johnson*,LSU,SEC,13,7,14,2.0,0,1.1,5,22,4.4,1,1.7,12,36,3.0,1,,jujuan-johnson-1
1113,Kisean Johnson*,Western Kentucky,CUSA,14,3,14,4.7,0,1.0,75,925,12.3,7,66.1,78,939,12.0,7,,kisean-johnson-1
1114,Lieghton Bechdel*,West Virginia,Big 12,13,1,14,14.0,1,1.1,0,0,,0,0.0,1,14,14.0,1,,lieghton-bechdel-1
1115,Marcus Sanders Jr.*,Georgia Southern,Sun Belt,10,2,14,7.0,0,1.4,9,158,17.6,1,15.8,11,172,15.6,1,,marcus-sanders-jr-1
1116,Mikey Pearson*,Navy,American,2,2,14,7.0,0,7.0,0,0,,0,0.0,2,14,7.0,0,,mikey-pearson-1
1117,Pat Bryant*,Illinois,Big Ten,12,5,14,2.8,0,1.2,54,984,18.2,10,82.0,59,998,16.9,10,,pat-bryant-1
1118,Sean Atkins*,South Florida,American,13,1,14,14.0,0,1.1,79,781,9.9,2,60.1,80,795,9.9,2,,sean-atkins-1
1119,Tykeem Wallace,Kennesaw State,CUSA,12,6,14,2.3,0,1.2,24,198,8.3,0,16.5,30,212,7.1,0,,tykeem-wallace-1
1120,Wise Segars Jr.,Clemson,ACC,2,2,14,7.0,0,7.0,0,0,,0,0.0,2,14,7.0,0,,wise-segars-jr-1
1121,Daniel Jackson*,Minnesota,Big Ten,12,3,13,4.3,0,1.1,75,863,11.5,4,71.9,78,876,11.2,4,,daniel-jackson-5
1122,Demarcus Lacey*,Jacksonville State,CUSA,7,5,13,2.6,0,1.9,8,84,10.5,0,12.0,13,97,7.5,0,,demarcus-lacey-1
1123,Devin Brown*,Ohio State,Big Ten,9,7,13,1.9,0,1.4,0,0,,0,0.0,7,13,1.9,0,,devin-brown-2
1124,Drae McCray*,Texas Tech,Big 12,10,1,13,13.0,0,1.3,12,74,6.2,0,7.4,13,87,6.7,0,,drae-mccray-1
1125,Evan Cantu*,Kansas State,Big 12,1,3,13,4.3,0,13.0,0,0,,0,0.0,3,13,4.3,0,,evan-cantu-1
1126,Fame Ijeboi*,Minnesota,Big Ten,2,2,13,6.5,0,6.5,0,0,,0,0.0,2,13,6.5,0,,fame-ijeboi-1
1127,Gavin Harris,Central Michigan,MAC,10,1,13,13.0,1,1.3,11,173,15.7,1,17.3,12,186,15.5,2,,gavin-harris-1
1128,Jacob Gill*,Iowa,Big Ten,13,5,13,2.6,0,1.0,35,411,11.7,2,31.6,40,424,10.6,2,,jacob-gill-3
1129,Jay Maclin,Kentucky,SEC,12,2,13,6.5,0,1.1,13,313,24.1,4,26.1,15,326,21.7,4,,jay-maclin-1
1130,Jayden McGowan*,Boston College,ACC,11,2,13,6.5,0,1.2,2,0,0.0,0,0.0,4,13,3.3,0,,jayden-mcgowan-1
1131,Jaylin Lucas,Florida State,ACC,2,2,13,6.5,0,6.5,3,39,13.0,0,19.5,5,52,10.4,0,,jaylin-lucas-1
1132,Kaedin Robinson,Appalachian State,Sun Belt,9,1,13,13.0,0,1.4,53,840,15.8,2,93.3,54,853,15.8,2,,kaedin-robinson-1
1133,Kendrell Williams*,Louisiana,Sun Belt,3,5,13,2.6,0,4.3,0,0,,0,0.0,5,13,2.6,0,,kendrell-williams-1
1134,Malcolm Simmons,Auburn,SEC,12,4,13,3.3,0,1.1,40,451,11.3,3,37.6,44,464,10.5,3,,malcolm-simmons-3
1135,Marlion Jackson*,Louisiana Tech,CUSA,10,5,13,2.6,0,1.3,14,222,15.9,1,22.2,19,235,12.4,1,,marlion-jackson-1
1136,Marquese Williams,Akron,MAC,6,6,13,2.2,0,2.2,0,0,,0,0.0,6,13,2.2,0,,marquese-williams-1
1137,Melquan Stovall,Arizona State,Big 12,14,3,13,4.3,0,0.9,24,287,12.0,0,20.5,27,300,11.1,0,,melquan-stovall-1
1138,Nazeviah Burris,Florida International,CUSA,8,2,13,6.5,0,1.6,22,209,9.5,1,26.1,24,222,9.3,1,,nazeviah-burris-1
1139,Rayshon Luke,Arizona,Big 12,4,4,13,3.3,0,3.3,6,52,8.7,0,13.0,10,65,6.5,0,,rayshon-luke-1
1140,Samario Rudolph*,Jacksonville State,CUSA,14,2,13,6.5,0,0.9,9,74,8.2,0,5.3,11,87,7.9,0,,samario-rudolph-1
1141,Sean Jackson,Auburn,SEC,12,3,13,4.3,0,1.1,0,0,,0,0.0,3,13,4.3,0,,sean-jackson-3
1142,Tony Johnson,Cincinnati,Big 12,12,2,13,6.5,0,1.1,48,449,9.4,6,37.4,50,462,9.2,6,,tony-johnson-10
1143,Willie McCoy*,UTSA,American,11,4,13,3.3,0,1.2,28,536,19.1,4,48.7,32,549,17.2,4,,willie-mccoy-1
1144,Abdul-Fatai Ibrahim*,Louisiana Tech,CUSA,13,2,12,6.0,0,0.9,14,121,8.6,0,9.3,16,133,8.3,0,,abdul-fatai-ibrahim-1
1145,Cameron Breier,Air Force,MWC,12,2,12,6.0,0,1.0,0,0,,0,0.0,2,12,6.0,0,,cameron-breier-1
1146,Christian Gelov,Purdue,Big Ten,1,1,12,12.0,0,12.0,0,0,,0,0.0,1,12,12.0,0,,christian-gelov-1
1147,Dawaiian McNeely,Wyoming,MWC,2,2,12,6.0,0,6.0,0,0,,0,0.0,2,12,6.0,0,,dawaiian-mcneely-1
1148,DeAndre Buchannon*,Georgia Southern,Sun Belt,12,5,12,2.4,0,1.0,5,54,10.8,0,4.5,10,66,6.6,0,,deandre-buchannon-1
1149,Donte Hawthorne,Virginia,ACC,9,1,12,12.0,0,1.3,1,2,2.0,0,0.2,2,14,7.0,0,,donte-hawthorne-1
1150,E.J. Warner,Rice,American,11,29,12,0.4,1,1.1,0,0,,0,0.0,29,12,0.4,1,,ej-warner-1
1151,Jahdae Walker*,Texas A&M,SEC,13,3,12,4.0,0,0.9,29,345,11.9,2,26.5,32,357,11.2,2,,jahdae-walker-1
1152,Jordan Anderson*,Illinois,Big Ten,13,6,12,2.0,0,0.9,0,0,,0,0.0,6,12,2.0,0,,jordan-anderson-4
1153,Ken Seals*,Texas Christian,Big 12,6,4,12,3.0,0,2.0,0,0,,0,0.0,4,12,3.0,0,,ken-seals-1
1154,Kenny Minchey*,Notre Dame,Ind,1,2,12,6.0,1,12.0,0,0,,0,0.0,2,12,6.0,1,,kenny-minchey-1
1155,La'James White*,Kansas State,Big 12,4,1,12,12.0,1,3.0,0,0,,0,0.0,1,12,12.0,1,,lajames-white-1
1156,Liam Clifford*,Penn State,Big Ten,16,1,12,12.0,0,0.8,18,286,15.9,1,17.9,19,298,15.7,1,,liam-clifford-1
1157,Mario Williams*,Tulane,American,14,2,12,6.0,0,0.9,60,1031,17.2,6,73.6,62,1043,16.8,6,,mario-williams-2
1158,MJ Morris,Maryland,Big Ten,7,28,12,0.4,1,1.7,0,0,,0,0.0,28,12,0.4,1,,mj-morris-1
1159,Oliver Straw*,West Virginia,Big 12,13,1,12,12.0,0,0.9,0,0,,0,0.0,1,12,12.0,0,,oliver-straw-1
1160,Oronde Gadsden II*,Syracuse,ACC,13,1,12,12.0,0,0.9,73,934,12.8,7,71.8,74,946,12.8,7,,oronde-gadsden-ii-1
1161,Patrick Wilk,Tennessee,SEC,3,3,12,4.0,0,4.0,0,0,,0,0.0,3,12,4.0,0,,patrick-wilk-1
1162,Reese Poffenbarger*,Miami (FL),ACC,4,5,12,2.4,0,3.0,0,0,,0,0.0,5,12,2.4,0,,reese-poffenbarger-1
1163,Sieh Bangura*,Minnesota,Big Ten,3,4,12,3.0,0,4.0,0,0,,0,0.0,4,12,3.0,0,,sieh-bangura-1
1164,Bailey Stockton*,Georgia Tech,ACC,13,2,11,5.5,0,0.8,17,206,12.1,1,15.8,19,217,11.4,1,,bailey-stockton-1
1165,Hank Beatty*,Illinois,Big Ten,13,1,11,11.0,0,0.8,20,294,14.7,1,22.6,21,305,14.5,1,,beatty-hank-1
1166,Blake Baker*,Louisiana Tech,CUSA,3,17,11,0.6,1,3.7,0,0,,0,0.0,17,11,0.6,1,,blake-baker-1
1167,Brandon Johnson,Arizona,Big 12,6,3,11,3.7,0,1.8,0,0,,0,0.0,3,11,3.7,0,,brandon-johnson-17
1168,Christian Davis,Ball State,MAC,11,11,11,1.0,0,1.0,1,3,3.0,0,0.3,12,14,1.2,0,,christian-davis-2
1169,Dannis Jackson,Southern Mississippi,Sun Belt,10,2,11,5.5,0,1.1,11,210,19.1,0,21.0,13,221,17.0,0,,dannis-jackson-1
1170,De'Nylon Morrissette,Purdue,Big Ten,11,1,11,11.0,0,1.0,11,106,9.6,2,9.6,12,117,9.8,2,,denylon-morrissette-1
1171,George Dimopoulus*,Northern Illinois,MAC,13,2,11,5.5,0,0.8,6,57,9.5,0,4.4,8,68,8.5,0,,george-dimopoulus-1
1172,Janiran Bonner*,Nebraska,Big Ten,13,2,11,5.5,1,0.8,11,67,6.1,1,5.2,13,78,6.0,2,,janiran-bonner-1
1173,Kalib Hicks*,Oklahoma,SEC,5,2,11,5.5,0,2.2,0,0,,0,0.0,2,11,5.5,0,,kalib-hicks-1
1174,Kevin Coleman Jr.,Mississippi State,SEC,12,4,11,2.8,0,0.9,74,932,12.6,6,77.7,78,943,12.1,6,,kevin-coleman-jr-1
1175,Landry Lyddy,UAB,American,2,1,11,11.0,0,5.5,0,0,,0,0.0,1,11,11.0,0,,landry-lyddy-1
1176,Mar'Kel Porter*,Bowling Green,MAC,2,4,11,2.8,0,5.5,0,0,,0,0.0,4,11,2.8,0,,markel-porter-1
1177,Solomon Lewis*,Louisiana Tech,CUSA,12,3,11,3.7,0,0.9,16,220,13.8,3,18.3,19,231,12.2,3,,solomon-lewis-1
1178,Stephen Kittleman,Tulsa,American,12,2,11,5.5,1,0.9,0,0,,0,0.0,2,11,5.5,1,,stephen-kittleman-1
1179,Taji Hudson*,James Madison,Sun Belt,11,1,11,11.0,0,1.0,3,30,10.0,0,2.7,4,41,10.3,0,,taji-hudson-1
1180,Tank Hawkins*,Florida,SEC,8,3,11,3.7,0,1.4,10,100,10.0,1,12.5,13,111,8.5,1,,tank-hawkins-1
1181,Travis Egan*,Louisville,ACC,12,2,11,5.5,0,0.9,0,0,,0,0.0,2,11,5.5,0,,travis-egan-1
1182,Trech Kekahuna,Wisconsin,Big Ten,12,1,11,11.0,0,0.9,25,339,13.6,2,28.3,26,350,13.5,2,,trech-kekahuna-1
1183,Troy Stellato,Clemson,ACC,9,1,11,11.0,0,1.2,25,264,10.6,1,29.3,26,275,10.6,1,,troy-stellato-1
1184,Zeed Haynes*,Syracuse,ACC,2,1,11,11.0,0,5.5,8,97,12.1,0,48.5,9,108,12.0,0,,zeed-haynes-1
1185,Antonio Jones,Temple,American,12,3,10,3.3,0,0.8,23,170,7.4,1,14.2,26,180,6.9,1,,antonio-jones-2
1186,Cade Wolford,Kent State,MAC,3,4,10,2.5,0,3.3,0,0,,0,0.0,4,10,2.5,0,,cade-wolford-1
1187,Cole Pennington,Marshall,Sun Belt,3,2,10,5.0,0,3.3,0,0,,0,0.0,2,10,5.0,0,,cole-pennington-1
1188,Da'Quan Felton*,Virginia Tech,ACC,12,1,10,10.0,0,0.8,32,360,11.3,2,30.0,33,370,11.2,2,,daquan-felton-1
1189,Drelon Miller*,Colorado,Big 12,13,4,10,2.5,0,0.8,32,277,8.7,3,21.3,36,287,8.0,3,,drelon-miller-1
1190,Elliott Nimrod,Utah State,MWC,12,1,10,10.0,0,0.8,0,0,,0,0.0,1,10,10.0,0,,elliott-nimrod-1
1191,Hank Brown,Auburn,SEC,4,3,10,3.3,0,2.5,0,0,,0,0.0,3,10,3.3,0,,hank-brown-1
1192,Isaiah Rudison,New Mexico State,CUSA,12,1,10,10.0,0,0.8,2,26,13.0,0,2.2,3,36,12.0,0,,isaiah-rudison-1
1193,Jake Arthurs,Northwestern,Big Ten,12,2,10,5.0,1,0.8,2,6,3.0,0,0.5,4,16,4.0,1,,jake-arthurs-1
1194,Jordan Faison*,Notre Dame,Ind,13,3,10,3.3,0,0.8,30,356,11.9,1,27.4,33,366,11.1,1,,jordan-faison-1
1195,Josh Joyner*,Washington State,Ind,1,2,10,5.0,0,10.0,0,0,,0,0.0,2,10,5.0,0,,josh-joyner-1
1196,Junior Vandeross III*,Toledo,MAC,13,2,10,5.0,0,0.8,85,957,11.3,5,73.6,87,967,11.1,5,,junior-vandeross-iii-1
1197,Lance Legendre*,Louisiana,Sun Belt,14,1,10,10.0,0,0.7,49,826,16.9,6,59.0,50,836,16.7,6,,lance-legendre-1
1198,Mark Crawford*,Minnesota,Big Ten,13,1,10,10.0,0,0.8,0,0,,0,0.0,1,10,10.0,0,,mark-crawford-4
1199,Max Johnson*,North Carolina,ACC,1,6,10,1.7,1,10.0,0,0,,0,0.0,6,10,1.7,1,,max-johnson-2
1200,Roman Mothershead,Troy,Sun Belt,10,2,10,5.0,0,1.0,4,38,9.5,0,3.8,6,48,8.0,0,,roman-mothershead-1
1201,T.Y. Harding,Massachusetts,Ind,11,2,10,5.0,0,0.9,19,334,17.6,5,30.4,21,344,16.4,5,,ty-harding-1
1202,Zach Hernandez,SMU,ACC,2,5,10,2.0,0,5.0,0,0,,0,0.0,5,10,2.0,0,,zach-hernandez-2
1203,Zane Minors,SMU,ACC,1,2,10,5.0,0,10.0,0,0,,0,0.0,2,10,5.0,0,,zane-minors-1
1204,AJ Williams*,Army,American,4,2,9,4.5,0,2.3,0,0,,0,0.0,2,9,4.5,0,,aj-williams-3
1205,Caleb Hampton,Stanford,ACC,3,2,9,4.5,0,3.0,0,0,,0,0.0,2,9,4.5,0,,caleb-hampton-1
1206,Carter Shaw,UCLA,Big Ten,6,2,9,4.5,0,1.5,2,45,22.5,0,7.5,4,54,13.5,0,,carter-shaw-1
1207,Cristian Driver*,Minnesota,Big Ten,11,2,9,4.5,0,0.8,7,49,7.0,1,4.5,9,58,6.4,1,,cristian-driver-1
1208,Daniyel Ngata*,Washington,Big Ten,13,4,9,2.3,0,0.7,0,0,,0,0.0,4,9,2.3,0,,daniyel-ngata-1
1209,DJ Scott,Kennesaw State,CUSA,12,2,9,4.5,0,0.8,0,0,,0,0.0,2,9,4.5,0,,dj-scott-3
1210,Dorian Smith*,South Alabama,Sun Belt,1,1,9,9.0,0,9.0,0,0,,0,0.0,1,9,9.0,0,,dorian-smith-2
1211,Hardley Gilmore IV,Kentucky,SEC,7,1,9,9.0,0,1.3,6,153,25.5,1,21.9,7,162,23.1,1,,hardley-gilmore-iv-1
1212,Jaden Williams*,Texas State,Sun Belt,13,1,9,9.0,0,0.7,57,807,14.2,7,62.1,58,816,14.1,7,,jaden-williams-1
1213,Jadon Jackson*,Kansas State,Big 12,12,2,9,4.5,0,0.8,15,207,13.8,1,17.3,17,216,12.7,1,,jadon-jackson-1
1214,Jesse Mirco*,Vanderbilt,SEC,13,1,9,9.0,0,0.7,0,0,,0,0.0,1,9,9.0,0,,jesse-mirco-1
1215,John Adams,Temple,American,12,3,9,3.0,0,0.8,16,194,12.1,1,16.2,19,203,10.7,1,,john-adams-7
1216,Jordan Pollard*,San Jose State,MWC,13,1,9,9.0,0,0.7,0,0,,0,0.0,1,9,9.0,0,,jordan-pollard-1
1217,Kyle Koch*,North Texas,American,3,1,9,9.0,0,3.0,1,5,5.0,0,1.7,2,14,7.0,0,,kyle-koch-1
1218,Lex Thomas*,North Carolina State,ACC,2,1,9,9.0,0,4.5,0,0,,0,0.0,1,9,9.0,0,,lex-thomas-1
1219,Rece Verhoff,Marshall,Sun Belt,11,1,9,9.0,0,0.8,0,0,,0,0.0,1,9,9.0,0,,rece-verhoff-1
1220,Steve Angeli*,Notre Dame,Ind,11,9,9,1.0,0,0.8,0,0,,0,0.0,9,9,1.0,0,,steve-angeli-1
1221,Taylor Morin,Wake Forest,ACC,12,1,9,9.0,0,0.8,64,756,11.8,2,63.0,65,765,11.8,2,,taylor-morin-1
1222,Terrell McDonald,UAB,American,12,5,9,1.8,1,0.8,15,202,13.5,0,16.8,20,211,10.6,1,,terrell-mcdonald-1
1223,Trey Goodman,UTEP,CUSA,12,1,9,9.0,0,0.8,47,469,10.0,0,39.1,48,478,10.0,0,,trey-goodman-1
1224,Tucker McDonald*,Connecticut,Ind,3,3,9,3.0,0,3.0,0,0,,0,0.0,3,9,3.0,0,,tucker-mcdonald-1
1225,Tyler Budge*,Georgia Southern,Sun Belt,1,1,9,9.0,0,9.0,0,0,,0,0.0,1,9,9.0,0,,tyler-budge-1
1226,Tyler Morris*,Michigan,Big Ten,11,1,9,9.0,0,0.8,23,248,10.8,2,22.5,24,257,10.7,2,,tyler-morris-2
1227,A.J. Henning,Northwestern,Big Ten,12,5,8,1.6,0,0.7,59,603,10.2,4,50.3,64,611,9.5,4,,aj-henning-1
1228,Amare Thomas,UAB,American,12,4,8,2.0,0,0.7,62,670,10.8,8,55.8,66,678,10.3,8,,amare-thomas-1
1229,Chris Edmonds*,Bowling Green,MAC,1,2,8,4.0,0,8.0,0,0,,0,0.0,2,8,4.0,0,,chris-edmonds-3
1230,Coleson Fields*,North Carolina State,ACC,5,3,8,2.7,0,1.6,0,0,,0,0.0,3,8,2.7,0,,coleson-fields-1
1231,Isaiah Hardge*,Colorado,Big 12,11,2,8,4.0,0,0.7,1,39,39.0,0,3.5,3,47,15.7,0,,isaiah-hardge-1
1232,Jack Shields*,Buffalo,MAC,3,4,8,2.0,0,2.7,0,0,,0,0.0,4,8,2.0,0,,jack-shields-3
1233,Jackson Brousseau*,Colorado State,MWC,1,1,8,8.0,0,8.0,0,0,,0,0.0,1,8,8.0,0,,jackson-brousseau-1
1234,Javarius Green*,North Carolina,ACC,5,1,8,8.0,0,1.6,1,12,12.0,0,2.4,2,20,10.0,0,,javarius-green-1
1235,Jayce Gardner,Middle Tennessee State,CUSA,11,1,8,8.0,0,0.7,0,0,,0,0.0,1,8,8.0,0,,jayce-gardner-1
1236,Jayvin Norman,Eastern Michigan,MAC,2,4,8,2.0,0,4.0,0,0,,0,0.0,4,8,2.0,0,,jayvin-norman-1
1237,Jordan Hudson,SMU,ACC,14,1,8,8.0,0,0.6,39,422,10.8,5,30.1,40,430,10.8,5,,jordan-hudson-1
1238,Keagan Johnson*,Kansas State,Big 12,11,1,8,8.0,0,0.7,29,359,12.4,1,32.6,30,367,12.2,1,,keagan-johnson-1
1239,Kwazi Gilmer,UCLA,Big Ten,12,1,8,8.0,0,0.7,31,345,11.1,2,28.8,32,353,11.0,2,,kwazi-gilmer-1
1240,Maurice Mazzccua*,Nebraska,Big Ten,2,5,8,1.6,0,4.0,0,0,,0,0.0,5,8,1.6,0,,maurice-mazzccua-1
1241,Nate Milanowski*,Miami (OH),MAC,2,4,8,2.0,0,4.0,0,0,,0,0.0,4,8,2.0,0,,nate-milanowski-1
1242,Seth Anderson*,Iowa,Big Ten,7,2,8,4.0,0,1.1,5,106,21.2,0,15.1,7,114,16.3,0,,seth-anderson-1
1243,Trent Walker,Oregon State,Ind,12,4,8,2.0,0,0.7,81,901,11.1,2,75.1,85,909,10.7,2,,trent-walker-1
1244,Will Ferrin*,BYU,Big 12,13,1,8,8.0,0,0.6,0,0,,0,0.0,1,8,8.0,0,,will-ferrin-1
1245,Xavier Williams,Middle Tennessee State,CUSA,10,4,8,2.0,0,0.8,0,0,,0,0.0,4,8,2.0,0,,xavier-williams-4
1246,AJ Bianco,Nevada,MWC,5,6,7,1.2,0,1.4,0,0,,0,0.0,6,7,1.2,0,,aj-bianco-1
1247,Buck Buchanan*,Louisiana Tech,CUSA,12,1,7,7.0,0,0.6,0,0,,0,0.0,1,7,7.0,0,,buck-buchanan-1
1248,Cade McDonald*,Miami (OH),MAC,12,1,7,7.0,0,0.6,52,631,12.1,3,52.6,53,638,12.0,3,,cade-mcdonald-1
1249,Casey Cain*,Nevada-Las Vegas,MWC,13,1,7,7.0,0,0.5,7,136,19.4,2,10.5,8,143,17.9,2,,casey-cain-1
1250,Chandler Pittman,Southern Mississippi,Sun Belt,10,2,7,3.5,0,0.7,8,51,6.4,0,5.1,10,58,5.8,0,,chandler-pittman-1
1251,Chris Hunter,Arizona,Big 12,12,1,7,7.0,0,0.6,35,323,9.2,3,26.9,36,330,9.2,3,,chris-hunter-5
1252,Chris Wheatley-Humphrey*,Miami (FL),ACC,1,1,7,7.0,0,7.0,0,0,,0,0.0,1,7,7.0,0,,chris-wheatley-humphrey-1
1253,C'Quan Jnopierre,Florida International,CUSA,11,6,7,1.2,0,0.6,10,71,7.1,0,6.5,16,78,4.9,0,,cquan-jnopierre-1
1254,Darius Copeland*,Liberty,CUSA,3,1,7,7.0,0,2.3,5,38,7.6,0,12.7,6,45,7.5,0,,darius-copeland-2
1255,Darius Stone,Air Force,MWC,1,3,7,2.3,0,7.0,0,0,,0,0.0,3,7,2.3,0,,darius-stone-1
1256,Derek Eusebio,Arizona State,Big 12,4,2,7,3.5,0,1.8,1,64,64.0,1,16.0,3,71,23.7,1,,derek-eusebio-1
1257,Easton Miller*,Iowa State,Big 12,13,2,7,3.5,0,0.5,0,0,,0,0.0,2,7,3.5,0,,easton-miller-1
1258,Eli Stowers*,Vanderbilt,SEC,13,6,7,1.2,0,0.5,49,638,13.0,5,49.1,55,645,11.7,5,,eli-stowers-1
1259,Jarris Williams,Troy,Sun Belt,1,2,7,3.5,0,7.0,0,0,,0,0.0,2,7,3.5,0,,jarris-williams-1
1260,Jordan Anthony*,Arkansas,SEC,12,2,7,3.5,0,0.6,8,111,13.9,1,9.3,10,118,11.8,1,,jordan-anthony-2
1261,Jordan Washington*,Washington,Big Ten,2,3,7,2.3,0,3.5,0,0,,0,0.0,3,7,2.3,0,,jordan-washington-4
1262,Josh Ringer*,Miami (OH),MAC,4,6,7,1.2,0,1.8,1,7,7.0,0,1.8,7,14,2.0,0,,josh-ringer-1
1263,Kenneth Womack*,Western Michigan,MAC,10,2,7,3.5,0,0.7,39,545,14.0,1,54.5,41,552,13.5,1,,kenneth-womack-1
1264,Kobe Johnson*,Colorado State,MWC,13,11,7,0.6,0,0.5,3,11,3.7,0,0.8,14,18,1.3,0,,kobe-johnson-1
1265,Kwinten Ives*,Nebraska,Big Ten,9,6,7,1.2,1,0.8,0,0,,0,0.0,6,7,1.2,1,,kwinten-ives-1
1266,Mario Craver,Mississippi State,SEC,9,3,7,2.3,0,0.8,17,368,21.6,3,40.9,20,375,18.8,3,,mario-craver-1
1267,Mason Williams*,Ohio,MAC,14,1,7,7.0,1,0.5,19,211,11.1,2,15.1,20,218,10.9,3,,mason-williams-3
1268,Montorie Foster,Michigan State,Big Ten,12,2,7,3.5,0,0.6,46,588,12.8,3,49.0,48,595,12.4,3,,montorie-foster-1
1269,Nate Hampton*,Liberty,CUSA,2,1,7,7.0,0,3.5,0,0,,0,0.0,1,7,7.0,0,,nate-hampton-1
1270,Omari Hayes,Florida Atlantic,American,11,3,7,2.3,0,0.6,39,590,15.1,3,53.6,42,597,14.2,3,,omari-hayes-1
1271,O'Mega Blake,Charlotte,American,12,2,7,3.5,0,0.6,32,795,24.8,9,66.3,34,802,23.6,9,,omega-blake-1
1272,Raheim Jeter*,East Carolina,American,6,1,7,7.0,0,1.2,0,0,,0,0.0,1,7,7.0,0,,raheim-jeter-1
1273,Ruel Tomlinson,Kent State,MAC,4,28,7,0.3,0,1.8,0,0,,0,0.0,28,7,0.3,0,,ruel-tomlinson-1
1274,Sutton Smith*,Memphis,American,1,3,7,2.3,0,7.0,2,13,6.5,0,13.0,5,20,4.0,0,,sutton-smith-2
1275,Ta'Quan Roberson*,Kansas State,Big 12,6,1,7,7.0,0,1.2,0,0,,0,0.0,1,7,7.0,0,,taquan-roberson-1
1276,Tony Freeman*,Washington State,Ind,13,1,7,7.0,0,0.5,8,125,15.6,0,9.6,9,132,14.7,0,,tony-freeman-1
1277,Billy Atkins*,James Madison,Sun Belt,3,2,6,3.0,0,2.0,0,0,,0,0.0,2,6,3.0,0,,billy-atkins-2
1278,Brett Gabbert*,Miami (OH),MAC,14,55,6,0.1,1,0.4,0,0,,0,0.0,55,6,0.1,1,,brett-gabbert-1
1279,Carter Campbell,SMU,ACC,9,1,6,6.0,0,0.7,2,10,5.0,0,1.1,3,16,5.3,0,,carter-campbell-1
1280,Daniel Shaban*,Connecticut,Ind,1,2,6,3.0,0,6.0,0,0,,0,0.0,2,6,3.0,0,,daniel-shaban-1
1281,Dante Moore,Oregon,Big Ten,5,1,6,6.0,0,1.2,0,0,,0,0.0,1,6,6.0,0,,dante-moore-1
1282,Darrell Gill Jr.*,Syracuse,ACC,12,2,6,3.0,0,0.5,31,570,18.4,2,47.5,33,576,17.5,2,,darrell-gill-jr-1
1283,Deuce Alexander,Wake Forest,ACC,12,2,6,3.0,0,0.5,36,400,11.1,2,33.3,38,406,10.7,2,,deuce-alexander-1
1284,Drake Lindsey*,Minnesota,Big Ten,3,1,6,6.0,0,2.0,0,0,,0,0.0,1,6,6.0,0,,drake-lindsey-1
1285,Emmett Mosley V,Stanford,ACC,9,12,6,0.5,0,0.7,48,525,10.9,6,58.3,60,531,8.9,6,,emmett-mosley-v-1
1286,Holden Geriner,Auburn,SEC,2,1,6,6.0,0,3.0,0,0,,0,0.0,1,6,6.0,0,,holden-geriner-1
1287,Isaiah Neyor*,Nebraska,Big Ten,12,2,6,3.0,0,0.5,34,455,13.4,5,37.9,36,461,12.8,5,,isaiah-neyor-1
1288,Isaiah Thacker,Ball State,MAC,8,1,6,6.0,0,0.8,0,0,,0,0.0,1,6,6.0,0,,isaiah-thacker-1
1289,Jack Turner*,Louisiana Tech,CUSA,7,13,6,0.5,0,0.9,0,0,,0,0.0,13,6,0.5,0,,jack-turner-1
1290,Jaden Bradley*,Nevada-Las Vegas,MWC,14,1,6,6.0,0,0.4,9,173,19.2,1,12.4,10,179,17.9,1,,jaden-bradley-1
1291,Jalen Moss*,Fresno State,MWC,12,1,6,6.0,0,0.5,48,563,11.7,4,46.9,49,569,11.6,4,,jalen-moss-1
1292,Joey Hobert*,Texas State,Sun Belt,12,3,6,2.0,0,0.5,70,680,9.7,8,56.7,73,686,9.4,8,,joey-hobert-1
1293,John Copenhaver*,North Carolina,ACC,13,1,6,6.0,0,0.5,40,414,10.4,4,31.8,41,420,10.2,4,,john-copenhaver-1
1294,Joseph Williams,Tulsa,American,12,1,6,6.0,0,0.5,30,588,19.6,5,49.0,31,594,19.2,5,,joseph-williams-3
1295,Lloyd Benson III*,Army,American,10,2,6,3.0,0,0.6,0,0,,0,0.0,2,6,3.0,0,,lloyd-benson-iii-1
1296,Marco Notarainni,Boise State,MWC,14,1,6,6.0,0,0.4,0,0,,0,0.0,1,6,6.0,0,,marco-notarainni-1
1297,Navelle Dean,Kennesaw State,CUSA,12,1,6,6.0,0,0.5,5,67,13.4,0,5.6,6,73,12.2,0,,navelle-dean-1
1298,Nyziah Hunter*,California,ACC,12,1,6,6.0,0,0.5,40,578,14.5,5,48.2,41,584,14.2,5,,nyziah-hunter-1
1299,Oscar Chapman,Auburn,SEC,12,1,6,6.0,0,0.5,0,0,,0,0.0,1,6,6.0,0,,oscar-chapman-1
1300,Pierce Clarkson*,Louisville,ACC,2,4,6,1.5,0,3.0,0,0,,0,0.0,4,6,1.5,0,,pierce-clarkson-1
1301,Ric'Darious Farmer*,West Virginia,Big 12,11,2,6,3.0,0,0.5,6,54,9.0,0,4.9,8,60,7.5,0,,ricdarious-farmer-1
1302,Romello Brinson,SMU,ACC,6,1,6,6.0,0,1.0,13,135,10.4,0,22.5,14,141,10.1,0,,romello-brinson-1
1303,Sean Brown*,North Carolina State,ACC,13,2,6,3.0,0,0.5,0,0,,0,0.0,2,6,3.0,0,,sean-brown-6
1304,Takye Heath*,Virginia Tech,ACC,7,1,6,6.0,0,0.9,1,5,5.0,0,0.7,2,11,5.5,0,,takye-heath-1
1305,Tanner Koziol,Ball State,MAC,12,1,6,6.0,0,0.5,94,839,8.9,8,69.9,95,845,8.9,8,,tanner-koziol-1
1306,Tristan Sinclair,Stanford,ACC,11,1,6,6.0,0,0.5,0,0,,0,0.0,1,6,6.0,0,,tristan-sinclair-1
1307,Ty Bowman*,Kansas State,Big 12,13,1,6,6.0,0,0.5,6,63,10.5,0,4.8,7,69,9.9,0,,ty-bowman-1
1308,Zion Ragins*,Oklahoma,SEC,13,2,6,3.0,0,0.5,10,68,6.8,0,5.2,12,74,6.2,0,,zion-ragins-1
1309,Bryce Farrell,Stanford,ACC,7,2,5,2.5,0,0.7,0,0,,0,0.0,2,5,2.5,0,,bryce-farrell-1
1310,Charles Montgomery,Marshall,Sun Belt,13,3,5,1.7,0,0.4,32,393,12.3,3,30.2,35,398,11.4,3,,charles-montgomery-1
1311,Davon Wells,Louisiana-Monroe,Sun Belt,12,4,5,1.3,0,0.4,29,262,9.0,2,21.8,33,267,8.1,2,,davon-wells-1
1312,Daylon Gordon*,Georgia Tech,ACC,13,2,5,2.5,0,0.4,0,0,,0,0.0,2,5,2.5,0,,daylon-gordon-1
1313,Dean Janikowski*,Washington State,Ind,13,1,5,5.0,0,0.4,0,0,,0,0.0,1,5,5.0,0,,dean-janikowski-1
1314,Douglas Emilien,Kansas,Big 12,11,1,5,5.0,0,0.5,3,20,6.7,1,1.8,4,25,6.3,1,,douglas-emilien-1
1315,Franklin Estrada*,Texas Christian,Big 12,3,3,5,1.7,0,1.7,0,0,,0,0.0,3,5,1.7,0,,franklin-estrada-1
1316,George Arata*,Tulane,American,1,2,5,2.5,0,5.0,0,0,,0,0.0,2,5,2.5,0,,george-arata-1
1317,Isiah Paige,Old Dominion,Sun Belt,12,4,5,1.3,0,0.4,61,819,13.4,3,68.3,65,824,12.7,3,,isiah-paige-1
1318,J. Michael Sturdivant,UCLA,Big Ten,11,1,5,5.0,0,0.5,22,315,14.3,2,28.6,23,320,13.9,2,,j-michael-sturdivant-1
1319,John Alan Richter*,Toledo,MAC,5,14,5,0.4,0,1.0,0,0,,0,0.0,14,5,0.4,0,,john-alan-richter-1
1320,Joshua Porter*,South Florida,American,13,1,5,5.0,0,0.4,25,230,9.2,0,17.7,26,235,9.0,0,,joshua-porter-1
1321,JR Gardner*,Alabama,SEC,3,2,5,2.5,0,1.7,0,0,,0,0.0,2,5,2.5,0,,jr-gardner-1
1322,Kenneth Williams*,Nebraska,Big Ten,2,1,5,5.0,0,2.5,0,0,,0,0.0,1,5,5.0,0,,kenneth-williams-5
1323,Kyle Hanks*,Liberty,CUSA,1,1,5,5.0,0,5.0,0,0,,0,0.0,1,5,5.0,0,,kyle-hanks-1
1324,Marcus Burke*,Florida,SEC,11,1,5,5.0,0,0.5,7,69,9.9,2,6.3,8,74,9.3,2,,marcus-burke-1
1325,Marquis Shoulders,Houston,Big 12,3,1,5,5.0,0,1.7,5,43,8.6,0,14.3,6,48,8.0,0,,marquis-shoulders-1
1326,Micahi Danzy,Florida State,ACC,4,2,5,2.5,0,1.3,1,38,38.0,0,9.5,3,43,14.3,0,,micahi-danzy-1
1327,Montana Lemonious-Craig,Arizona,Big 12,11,1,5,5.0,0,0.5,17,172,10.1,1,15.6,18,177,9.8,1,,montana-lemonious-craig-1
1328,Navy Shuler,Tennessee,SEC,2,2,5,2.5,0,2.5,0,0,,0,0.0,2,5,2.5,0,,navy-shuler-1
1329,PJ Johnson III,New Mexico State,CUSA,12,6,5,0.8,0,0.4,19,346,18.2,2,28.8,25,351,14.0,2,,pj-johnson-iii-1
1330,Roc Taylor*,Memphis,American,13,2,5,2.5,0,0.4,66,950,14.4,2,73.1,68,955,14.0,2,,roc-taylor-1
1331,Roman Gagliano,Middle Tennessee State,CUSA,3,2,5,2.5,0,1.7,0,0,,0,0.0,2,5,2.5,0,,roman-gagliano-1
1332,Shamar Rigby,Purdue,Big Ten,12,1,5,5.0,0,0.4,11,113,10.3,0,9.4,12,118,9.8,0,,shamar-rigby-1
1333,Torry Locklin,Kansas,Big 12,9,2,5,2.5,0,0.6,2,36,18.0,0,4.0,4,41,10.3,0,,torry-locklin-1
1334,Travis Hunter*,Colorado,Big 12,13,2,5,2.5,1,0.4,96,1258,13.1,15,96.8,98,1263,12.9,16,H-1BednarikAACamp,travis-hunter-2
1335,Ahmir Smith*,Northern Illinois,MAC,1,3,4,1.3,0,4.0,0,0,,0,0.0,3,4,1.3,0,,ahmir-smith-1
1336,Antonio Harris,Purdue,Big Ten,7,1,4,4.0,0,0.6,0,0,,0,0.0,1,4,4.0,0,,antonio-harris-3
1337,Antwane Wells Jr.*,Ole Miss,SEC,13,5,4,0.8,0,0.3,28,553,19.8,6,42.5,33,557,16.9,6,,antwane-wells-jr-1
1338,Ashtyn Hawkins*,Baylor,Big 12,13,3,4,1.3,0,0.3,45,567,12.6,5,43.6,48,571,11.9,5,,ashtyn-hawkins-1
1339,Barrett Carter,Clemson,ACC,14,1,4,4.0,1,0.3,0,0,,0,0.0,1,4,4.0,1,,barrett-carter-1
1340,Braedyn Locke,Wisconsin,Big Ten,11,22,4,0.2,2,0.4,0,0,,0,0.0,22,4,0.2,2,,braedyn-locke-1
1341,Charles Norman,Louisiana-Monroe,Sun Belt,11,3,4,1.3,0,0.4,0,0,,0,0.0,3,4,1.3,0,,charles-norman-1
1342,Chris Smith,Louisiana-Monroe,Sun Belt,1,1,4,4.0,0,4.0,0,0,,0,0.0,1,4,4.0,0,,chris-smith-27
1343,Demariyon Houston,Old Dominion,Sun Belt,9,1,4,4.0,0,0.4,9,83,9.2,3,9.2,10,87,8.7,3,,demariyon-houston-2
1344,Drayden Dickman,Rice,American,12,1,4,4.0,0,0.3,10,80,8.0,1,6.7,11,84,7.6,1,,drayden-dickman-1
1345,Gideon Ituka,Wisconsin,Big Ten,1,2,4,2.0,0,4.0,0,0,,0,0.0,2,4,2.0,0,,gideon-ituka-1
1346,Grant Page,Utah State,MWC,12,1,4,4.0,0,0.3,33,281,8.5,2,23.4,34,285,8.4,2,,grant-page-1
1347,Grayson Loftis*,Duke,ACC,2,2,4,2.0,0,2.0,0,0,,0,0.0,2,4,2.0,0,,grayson-loftis-1
1348,Harris Boyd*,Memphis,American,3,1,4,4.0,1,1.3,0,0,,0,0.0,1,4,4.0,1,,harris-boyd-1
1349,Jack Hestera,Utah State,MWC,11,1,4,4.0,0,0.4,24,340,14.2,4,30.9,25,344,13.8,4,,jack-hestera-1
1350,Jack Tuttle*,Michigan,Big Ten,2,15,4,0.3,0,2.0,0,0,,0,0.0,15,4,0.3,0,,jack-tuttle-1
1351,Jackson Acker,Wisconsin,Big Ten,12,1,4,4.0,0,0.3,5,29,5.8,0,2.4,6,33,5.5,0,,jackson-acker-1
1352,Jackson Stratton*,Iowa,Big Ten,3,6,4,0.7,0,1.3,0,0,,0,0.0,6,4,0.7,0,,jackson-stratton-1
1353,Jaylon Scott*,North Carolina State,ACC,1,3,4,1.3,0,4.0,0,0,,0,0.0,3,4,1.3,0,,jaylon-scott-2
1354,Jeremiah Hunter*,Washington,Big Ten,13,1,4,4.0,0,0.3,36,490,13.6,1,37.7,37,494,13.4,1,,jeremiah-hunter-1
1355,Joshua Manning*,Missouri,SEC,13,1,4,4.0,1,0.3,13,192,14.8,1,14.8,14,196,14.0,2,,joshua-manning-1
1356,Justin Fisher*,Notre Dame,Ind,11,1,4,4.0,0,0.4,1,16,16.0,0,1.5,2,20,10.0,0,,justin-fisher-1
1357,Keith Reynolds*,Washington,Big Ten,12,1,4,4.0,1,0.3,5,35,7.0,0,2.9,6,39,6.5,1,,keith-reynolds-2
1358,Kyrese Rowan,Utah State,MWC,12,2,4,2.0,1,0.3,44,526,12.0,3,43.8,46,530,11.5,4,,kyrese-rowan-2
1359,Lewis Bond*,Boston College,ACC,13,3,4,1.3,0,0.3,67,689,10.3,3,53.0,70,693,9.9,3,,lewis-bond-1
1360,Malik Phillips*,Sam Houston,CUSA,3,1,4,4.0,0,1.3,2,25,12.5,0,8.3,3,29,9.7,0,,malik-phillips-1
1361,Mekhi Anderson*,UTSA,American,3,1,4,4.0,0,1.3,0,0,,0,0.0,1,4,4.0,0,,mekhi-anderson-1
1362,Miles Coleman*,North Texas,American,11,2,4,2.0,0,0.4,36,378,10.5,2,34.4,38,382,10.1,2,,miles-coleman-1
1363,Mookie Cooper*,Missouri,SEC,7,1,4,4.0,0,0.6,12,235,19.6,0,33.6,13,239,18.4,0,,mookie-cooper-1
1364,Reese Burkhardt*,Texas Tech,Big 12,12,1,4,4.0,1,0.3,0,0,,0,0.0,1,4,4.0,1,,reese-burkhardt-1
1365,Ryan Staub*,Colorado,Big 12,4,3,4,1.3,0,1.0,0,0,,0,0.0,3,4,1.3,0,,ryan-staub-1
1366,Terrance Gibbs*,Georgia Southern,Sun Belt,5,1,4,4.0,0,0.8,1,2,2.0,0,0.4,2,6,3.0,0,,terrance-gibbs-1
1367,Tre' Hartwell*,Western Michigan,MAC,7,3,4,1.3,0,0.6,0,0,,0,0.0,3,4,1.3,0,,tre-hartwell-1
1368,Trey White,San Diego State,MWC,12,1,4,4.0,0,0.3,0,0,,0,0.0,1,4,4.0,0,,trey-white-1
1369,Tyler Buchner*,Notre Dame,Ind,2,1,4,4.0,0,2.0,0,0,,0,0.0,1,4,4.0,0,,tyler-buchner-1
1370,Vinny Anthony,Wisconsin,Big Ten,12,1,4,4.0,0,0.3,39,672,17.2,4,56.0,40,676,16.9,4,,vinny-anthony-1
1371,Will Pauling,Wisconsin,Big Ten,10,1,4,4.0,0,0.4,42,407,9.7,3,40.7,43,411,9.6,3,,will-pauling-1
1372,Yannick Smith*,East Carolina,American,13,2,4,2.0,0,0.3,25,434,17.4,3,33.4,27,438,16.2,3,,yannick-smith-1
1373,Albert Kunickis III,Northwestern,Big Ten,3,1,3,3.0,0,1.0,0,0,,0,0.0,1,3,3.0,0,,albert-kunickis-iii-1
1374,Arhmad Branch,Purdue,Big Ten,5,1,3,3.0,1,0.6,0,0,,0,0.0,1,3,3.0,1,,arhmad-branch-1
1375,Bryce Childress*,Western Kentucky,CUSA,12,2,3,1.5,0,0.3,6,73,12.2,0,6.1,8,76,9.5,0,,bryce-childress-2
1376,Charlie Becker,Indiana,Big Ten,12,1,3,3.0,1,0.3,0,0,,0,0.0,1,3,3.0,1,,charlie-becker-1
1377,Chase Curtis*,Texas Christian,Big 12,4,1,3,3.0,0,0.8,7,77,11.0,1,19.3,8,80,10.0,1,,chase-curtis-1
1378,Chris Durr,Wyoming,MWC,12,1,3,3.0,0,0.3,31,348,11.2,1,29.0,32,351,11.0,1,,chris-durr-1
1379,Christian Moore*,Nevada-Las Vegas,MWC,13,1,3,3.0,0,0.2,2,28,14.0,0,2.2,3,31,10.3,0,,christian-moore-1
1380,Dematrius Davis*,UTSA,American,1,1,3,3.0,0,3.0,0,0,,0,0.0,1,3,3.0,0,,dematrius-davis-1
1381,Dominick Mazotti,Massachusetts,Ind,10,1,3,3.0,0,0.3,18,183,10.2,1,18.3,19,186,9.8,1,,dominick-mazotti-1
1382,Fred Farrier II,Kentucky,SEC,12,1,3,3.0,0,0.3,13,126,9.7,0,10.5,14,129,9.2,0,,fred-farrier-ii-1
1383,Gage Leonard*,Navy,American,10,1,3,3.0,0,0.3,0,0,,0,0.0,1,3,3.0,0,,gage-leonard-1
1384,Jacob Jordan*,Oklahoma,SEC,7,1,3,3.0,0,0.4,27,234,8.7,1,33.4,28,237,8.5,1,,jacob-jordan-2
1385,Jalen Royals,Utah State,MWC,7,1,3,3.0,0,0.4,55,834,15.2,6,119.1,56,837,14.9,6,,jalen-royals-1
1386,Jamaal Pritchett*,South Alabama,Sun Belt,12,1,3,3.0,0,0.3,91,1127,12.4,9,93.9,92,1130,12.3,9,,jamaal-pritchett-1
1387,Jaydn Girard,Wake Forest,ACC,8,1,3,3.0,0,0.4,1,25,25.0,0,3.1,2,28,14.0,0,,jaydn-girard-1
1388,JayShon Ridgle,Houston,Big 12,11,1,3,3.0,0,0.3,2,10,5.0,0,0.9,3,13,4.3,0,,jayshon-ridgle-1
1389,Jimmy Horn Jr.*,Colorado,Big 12,11,1,3,3.0,0,0.3,37,441,11.9,1,40.1,38,444,11.7,1,,jimmy-horn-jr-1
1390,John Paul Richardson*,Texas Christian,Big 12,13,1,3,3.0,0,0.2,57,733,12.9,2,56.4,58,736,12.7,2,,john-paul-richardson-1
1391,Jonathan Paylor*,North Carolina State,ACC,3,1,3,3.0,0,1.0,0,0,,0,0.0,1,3,3.0,0,,jonathan-paylor-1
1392,Jordan McCants*,Jacksonville State,CUSA,14,1,3,3.0,0,0.2,15,146,9.7,0,10.4,16,149,9.3,0,,jordan-mccants-1
1393,Josiah McLaurin,Maryland,Big Ten,6,2,3,1.5,0,0.5,2,29,14.5,1,4.8,4,32,8.0,1,,josiah-mclaurin-1
1394,KJ Jackson*,Arkansas,SEC,1,1,3,3.0,0,3.0,0,0,,0,0.0,1,3,3.0,0,,kj-jackson-1
1395,Kole Wilson*,Texas State,Sun Belt,12,1,3,3.0,0,0.3,43,630,14.7,4,52.5,44,633,14.4,4,,kole-wilson-1
1396,Marshall Lang,Northwestern,Big Ten,12,1,3,3.0,0,0.3,11,115,10.5,1,9.6,12,118,9.8,1,,marshall-lang-2
1397,Mason Maggs*,Ohio State,Big Ten,1,1,3,3.0,0,3.0,0,0,,0,0.0,1,3,3.0,0,,mason-maggs-1
1398,Max Reese,Eastern Michigan,MAC,12,1,3,3.0,0,0.3,27,232,8.6,2,19.3,28,235,8.4,2,,max-reese-1
1399,Michael Lorino*,Alabama,SEC,1,1,3,3.0,0,3.0,0,0,,0,0.0,1,3,3.0,0,,michael-lorino-1
1400,Monaray Baldwin*,Baylor,Big 12,13,3,3,1.0,0,0.2,27,478,17.7,5,36.8,30,481,16.0,5,,monaray-baldwin-1
1401,Money Parks,Utah,Big 12,8,1,3,3.0,0,0.4,21,294,14.0,3,36.8,22,297,13.5,3,,money-parks-1
1402,Roderick Robinson II,Georgia,SEC,2,4,3,0.8,0,1.5,2,34,17.0,0,17.0,6,37,6.2,0,,roderick-robinson-ii-1
1403,Ross James,Oregon,Big Ten,13,1,3,3.0,0,0.2,0,0,,0,0.0,1,3,3.0,0,,ross-james-1
1404,Trexler Ivey,Charlotte,American,8,4,3,0.8,0,0.4,0,0,,0,0.0,4,3,0.8,0,,trexler-ivey-1
1405,Trey Owens*,Texas,SEC,2,1,3,3.0,0,1.5,0,0,,0,0.0,1,3,3.0,0,,trey-owens-1
1406,Will Pelissier,Wyoming,MWC,12,1,3,3.0,0,0.3,14,212,15.1,0,17.7,15,215,14.3,0,,will-pelissier-1
1407,Zion Turner*,Jacksonville State,CUSA,1,1,3,3.0,0,3.0,0,0,,0,0.0,1,3,3.0,0,,zion-turner-1
1408,Bryce Caufield,Oregon State,Ind,12,1,2,2.0,0,0.2,6,90,15.0,1,7.5,7,92,13.1,1,,bryce-caufield-1
1409,Chase Jenkins,Rice,American,2,1,2,2.0,0,1.0,0,0,,0,0.0,1,2,2.0,0,,chase-jenkins-1
1410,Cole Skinner*,South Florida,American,10,1,2,2.0,0,0.2,0,0,,0,0.0,1,2,2.0,0,,cole-skinner-1
1411,Corey Smith,Tulsa,American,12,1,2,2.0,0,0.2,12,179,14.9,2,14.9,13,181,13.9,2,,corey-smith-9
1412,Dane Olson*,Colorado State,MWC,13,1,2,2.0,0,0.2,17,314,18.5,1,24.2,18,316,17.6,1,,dane-olson-1
1413,Daniel Evert,Temple,American,9,1,2,2.0,0,0.2,8,143,17.9,2,15.9,9,145,16.1,2,,daniel-evert-1
1414,Davis Beville*,South Carolina,SEC,3,4,2,0.5,0,0.7,0,0,,0,0.0,4,2,0.5,0,,davis-beville-1
1415,Derwin Burgess Jr.*,Georgia Southern,Sun Belt,13,1,2,2.0,0,0.2,59,659,11.2,3,50.7,60,661,11.0,3,,derwin-burgess-jr-1
1416,Devin Boddie Jr.,Wyoming,MWC,4,1,2,2.0,0,0.5,5,62,12.4,1,15.5,6,64,10.7,1,,devin-boddie-jr-1
1417,D'Shawntae Jones*,Miami (OH),MAC,1,1,2,2.0,0,2.0,0,0,,0,0.0,1,2,2.0,0,,dshawntae-jones-1
1418,Gavin Bartholomew*,Pitt,ACC,13,1,2,2.0,0,0.2,38,322,8.5,4,24.8,39,324,8.3,4,,gavin-bartholomew-1
1419,Hayden Large*,Iowa,Big Ten,12,2,2,1.0,0,0.2,3,18,6.0,0,1.5,5,20,4.0,0,,hayden-large-1
1420,Ismael Cisse,Stanford,ACC,12,4,2,0.5,0,0.2,26,241,9.3,2,20.1,30,243,8.1,2,,ismael-cisse-1
1421,Jake Tafelski*,Notre Dame,Ind,7,1,2,2.0,0,0.3,1,14,14.0,0,2.0,2,16,8.0,0,,jake-tafelski-1
1422,Jalyn Gramstad*,Nebraska,Big Ten,1,1,2,2.0,0,2.0,0,0,,0,0.0,1,2,2.0,0,,jalyn-gramstad-1
1423,Jameer Thomas*,Syracuse,ACC,2,2,2,1.0,0,1.0,0,0,,0,0.0,2,2,1.0,0,,jameer-thomas-1
1424,Jaylon Calhoun,Appalachian State,Sun Belt,6,1,2,2.0,0,0.3,0,0,,0,0.0,1,2,2.0,0,,jaylon-calhoun-1
1425,Kelvontay Dixon,SMU,ACC,13,1,2,2.0,0,0.2,21,386,18.4,1,29.7,22,388,17.6,1,,kelvontay-dixon-1
1426,Kristen Hoskins*,Minnesota,Big Ten,1,1,2,2.0,0,2.0,0,0,,0,0.0,1,2,2.0,0,,kristen-hoskins-1
1427,Lemeke Brockington*,Minnesota,Big Ten,13,1,2,2.0,0,0.2,18,282,15.7,1,21.7,19,284,14.9,1,,lemeke-brockington-1
1428,Luke Hutchison*,Navy,American,13,1,2,2.0,0,0.2,4,28,7.0,0,2.2,5,30,6.0,0,,luke-hutchison-2
1429,Mabrey Mettauer,Wisconsin,Big Ten,3,1,2,2.0,0,0.7,0,0,,0,0.0,1,2,2.0,0,,mabrey-mettauer-1
1430,Malik Benson,Florida State,ACC,12,2,2,1.0,0,0.2,25,311,12.4,1,25.9,27,313,11.6,1,,malik-benson-1
1431,Marquis Johnson*,Missouri,SEC,12,2,2,1.0,0,0.2,25,352,14.1,1,29.3,27,354,13.1,1,,marquis-johnson-3
1432,Mekhi Nelson*,Nebraska,Big Ten,1,1,2,2.0,0,2.0,0,0,,0,0.0,1,2,2.0,0,,mekhi-nelson-1
1433,Octavian Smith Jr.,Maryland,Big Ten,11,1,2,2.0,0,0.2,30,315,10.5,2,28.6,31,317,10.2,2,,octavian-smith-jr-1
1434,Terrell Crosby*,Toledo,MAC,12,1,2,2.0,0,0.2,1,2,2.0,0,0.2,2,4,2.0,0,,terrell-crosby-1
1435,Thai Chiaokhiao-Bowman,Rice,American,5,1,2,2.0,0,0.4,15,125,8.3,1,25.0,16,127,7.9,1,,thai-chiaokhiao-bowman-1
1436,Titus Mokiao-Atimalala,UCLA,Big Ten,9,1,2,2.0,0,0.2,28,294,10.5,1,32.7,29,296,10.2,1,,titus-mokiao-atimalala-1
1437,Traylon Ray*,West Virginia,Big 12,10,1,2,2.0,0,0.2,28,426,15.2,4,42.6,29,428,14.8,4,,traylon-ray-1
1438,Trever Jackson,Florida State,ACC,1,1,2,2.0,0,2.0,0,0,,0,0.0,1,2,2.0,0,,trever-jackson-1
1439,Tyrei Washington,Temple,American,4,3,2,0.7,0,0.5,2,8,4.0,0,2.0,5,10,2.0,0,,tyrei-washington-1
1440,Will Perry,Massachusetts,Ind,1,1,2,2.0,0,2.0,0,0,,0,0.0,1,2,2.0,0,,will-perry-1
1441,Xander Lamb,Charlotte,American,8,1,2,2.0,0,0.3,0,0,,0,0.0,1,2,2.0,0,,xander-lamb-1
1442,Al Wooten II*,Duke,ACC,4,2,1,0.5,0,0.3,0,0,,0,0.0,2,1,0.5,0,,al-wooten-ii-1
1443,Anthony Garcia,Arizona,Big 12,1,1,1,1.0,0,1.0,0,0,,0,0.0,1,1,1.0,0,,anthony-garcia-1
1444,Austin Acton*,Ole Miss,SEC,1,1,1,1.0,0,1.0,0,0,,0,0.0,1,1,1.0,0,,austin-acton-1
1445,Brandon Buckhaulter,UAB,American,3,1,1,1.0,0,0.3,2,18,9.0,0,6.0,3,19,6.3,0,,brandon-buckhaulter-1
1446,Cameron Carroll*,Florida,SEC,1,3,1,0.3,0,1.0,0,0,,0,0.0,3,1,0.3,0,,cameron-carroll-1
1447,Cam'ron Lacy,Middle Tennessee State,CUSA,12,1,1,1.0,0,0.1,20,190,9.5,0,15.8,21,191,9.1,0,,camron-lacy-1
1448,Cole Fuller*,Jacksonville State,CUSA,14,1,1,1.0,1,0.1,0,0,,0,0.0,1,1,1.0,1,,cole-fuller-1
1449,Cortez Braham,Nevada,MWC,13,1,1,1.0,0,0.1,56,724,12.9,4,55.7,57,725,12.7,4,,cortez-braham-1
1450,Damon Sisa*,Arkansas State,Sun Belt,1,1,1,1.0,0,1.0,0,0,,0,0.0,1,1,1.0,0,,damon-sisa-1
1451,Daniel Beale*,Louisiana,Sun Belt,3,7,1,0.1,0,0.3,0,0,,0,0.0,7,1,0.1,0,,daniel-beale-1
1452,Davis Lane Jr.,Virginia,ACC,8,1,1,1.0,0,0.1,0,0,,0,0.0,1,1,1.0,0,,davis-lane-jr-1
1453,Desmond Watson*,Florida,SEC,13,1,1,1.0,0,0.1,0,0,,0,0.0,1,1,1.0,0,,desmond-watson-1
1454,Diore Hubbard*,West Virginia,Big 12,2,1,1,1.0,0,0.5,0,0,,0,0.0,1,1,1.0,0,,diore-hubbard-1
1455,Duece Adams*,Louisville,ACC,1,1,1,1.0,0,1.0,0,0,,0,0.0,1,1,1.0,0,,duece-adams-1
1456,Ethan Hall,Tulsa,American,12,1,1,1.0,0,0.1,5,34,6.8,0,2.8,6,35,5.8,0,,ethan-hall-1
1457,Jake Tarwater*,Fresno State,MWC,7,1,1,1.0,0,0.1,5,20,4.0,0,2.9,6,21,3.5,0,,jake-tarwater-1
1458,Jared Casey,Kansas,Big 12,12,1,1,1.0,0,0.1,18,203,11.3,2,16.9,19,204,10.7,2,,jared-casey-2
1459,Jaylen Lloyd*,Nebraska,Big Ten,13,3,1,0.3,0,0.1,13,255,19.6,0,19.6,16,256,16.0,0,,jaylen-lloyd-1
1460,Jerjuan Newton*,Toledo,MAC,13,1,1,1.0,0,0.1,72,1048,14.6,11,80.6,73,1049,14.4,11,,jerjuan-newton-1
1461,JeyQuan Smith*,South Florida,American,13,1,1,1.0,0,0.1,6,106,17.7,0,8.2,7,107,15.3,0,,jeyquan-smith-1
1462,Jordyn Tyson,Arizona State,Big 12,12,1,1,1.0,0,0.1,75,1101,14.7,10,91.8,76,1102,14.5,10,,jordyn-tyson-1
1463,Joseph Martinez,Michigan State,Big Ten,9,1,1,1.0,0,0.1,0,0,,0,0.0,1,1,1.0,0,,joseph-martinez-1
1464,Julian Nixon,Louisiana-Monroe,Sun Belt,11,1,1,1.0,0,0.1,9,91,10.1,1,8.3,10,92,9.2,1,,julian-nixon-2
1465,Kameron Ingram,UCF,Big 12,3,2,1,0.5,0,0.3,0,0,,0,0.0,2,1,0.5,0,,kameron-ingram-1
1466,Keyshawn Smith,SMU,ACC,14,2,1,0.5,0,0.1,33,527,16.0,5,37.6,35,528,15.1,5,,keyshawn-smith-1
1467,Kyre Duplessis*,Coastal Carolina,Sun Belt,12,1,1,1.0,0,0.1,5,78,15.6,0,6.5,6,79,13.2,0,,kyre-duplessis-1
1468,Lawayne McCoy,Florida State,ACC,10,1,1,1.0,0,0.1,6,52,8.7,0,5.2,7,53,7.6,0,,lawayne-mccoy-1
1469,Matthew Killam,Nevada,MWC,10,1,1,1.0,0,0.1,0,0,,0,0.0,1,1,1.0,0,,matthew-killam-1
1470,Michael Kern,Wake Forest,ACC,6,8,1,0.1,0,0.2,0,0,,0,0.0,8,1,0.1,0,,michael-kern-1
1471,Miles Kitselman,Tennessee,SEC,13,2,1,0.5,1,0.1,22,301,13.7,4,23.2,24,302,12.6,5,,miles-kitselman-1
1472,Nyck Harbor*,South Carolina,SEC,13,1,1,1.0,0,0.1,26,376,14.5,3,28.9,27,377,14.0,3,,nyck-harbor-1
1473,Omari Evans*,Penn State,Big Ten,16,1,1,1.0,0,0.1,21,415,19.8,5,25.9,22,416,18.9,5,,omari-evans-1
1474,Peter Montini*,Colorado State,MWC,12,2,1,0.5,1,0.1,5,42,8.4,0,3.5,7,43,6.1,1,,peter-montini-1
1475,Ricky White*,Nevada-Las Vegas,MWC,13,1,1,1.0,0,0.1,79,1041,13.2,11,80.1,80,1042,13.0,11,,ricky-white-2
1476,Sean Brown*,Duke,ACC,13,2,1,0.5,0,0.1,41,445,10.9,2,34.2,43,446,10.4,2,,sean-brown-8
1477,Tristen Brown*,Vanderbilt,SEC,10,1,1,1.0,0,0.1,3,27,9.0,0,2.7,4,28,7.0,0,,tristen-brown-1
1478,Trsiten Rigby,Clemson,ACC,4,1,1,1.0,0,0.3,0,0,,0,0.0,1,1,1.0,0,,trsiten-rigby-1
1479,Tru Edwards*,Louisiana Tech,CUSA,13,1,1,1.0,0,0.1,84,986,11.7,6,75.8,85,987,11.6,6,,tru-edwards-1
1480,Tyler Chandler*,Syracuse,ACC,1,1,1,1.0,0,1.0,0,0,,0,0.0,1,1,1.0,0,,tyler-chandler-1
1481,Yamir Knight*,James Madison,Sun Belt,13,1,1,1.0,0,0.1,53,605,11.4,4,46.5,54,606,11.2,4,,yamir-knight-1
1482,Zy'marion Lang*,Toledo,MAC,10,1,1,1.0,0,0.1,4,60,15.0,2,6.0,5,61,12.2,2,,zymarion-lang-1
1483,Brock Spalding*,East Carolina,American,7,1,0,0.0,0,0.0,5,71,14.2,0,10.1,6,71,11.8,0,,brock-spalding-1
1484,Da'Marion Alberic,Massachusetts,Ind,1,1,0,0.0,0,0.0,0,0,,0,0.0,1,0,0.0,0,,damarion-alberic-1
1485,Darius Lassiter*,BYU,Big 12,12,1,0,0.0,0,0.0,45,703,15.6,4,58.6,46,703,15.3,4,,darius-lassiter-1
1486,Dedrick Latulas*,Louisiana Tech,CUSA,4,1,0,0.0,0,0.0,1,4,4.0,0,1.0,2,4,2.0,0,,dedrick-latulas-1
1487,Eugene Wilson III*,Florida,SEC,4,1,0,0.0,0,0.0,19,266,14.0,1,66.5,20,266,13.3,1,,eugene-wilson-iii-1
1488,Hunter Tipton*,Louisiana Tech,CUSA,6,1,0,0.0,0,0.0,5,23,4.6,0,3.8,6,23,3.8,0,,hunter-tipton-1
1489,Jake Schultz,Oklahoma State,Big 12,12,1,0,0.0,0,0.0,3,68,22.7,0,5.7,4,68,17.0,0,,jake-schultz-1
1490,Jordan Ross*,Colorado State,MWC,13,2,0,0.0,0,0.0,15,218,14.5,1,16.8,17,218,12.8,1,,jordan-ross-2
1491,Kanon Woodill*,Northern Illinois,MAC,13,1,0,0.0,0,0.0,0,0,,0,0.0,1,0,0.0,0,,kanon-woodill-1
1492,LaJohntay Wester*,Colorado,Big 12,13,1,0,0.0,0,0.0,74,931,12.6,10,71.6,75,931,12.4,10,,lajohntay-wester-1
1493,Malique Dieudonne*,Western Michigan,MAC,11,1,0,0.0,0,0.0,13,230,17.7,2,20.9,14,230,16.4,2,,malique-dieudonne-1
1494,Marquez Taylor,UTEP,CUSA,3,1,0,0.0,0,0.0,0,0,,0,0.0,1,0,0.0,0,,marquez-taylor-1
1495,Maurice Brown*,South Carolina,SEC,13,1,0,0.0,0,0.0,1,1,1.0,1,0.1,2,1,0.5,1,,maurice-brown-2
1496,Michael Salgado-Medina,Arizona,Big 12,11,1,0,0.0,0,0.0,0,0,,0,0.0,1,0,0.0,0,,michael-salgado-medina-1
1497,Mike Brown-Stephens*,South Florida,American,13,1,0,0.0,0,0.0,29,379,13.1,4,29.2,30,379,12.6,4,,mike-brown-stephens-1
1498,Noah Kim*,Coastal Carolina,Sun Belt,7,13,0,0.0,0,0.0,0,0,,0,0.0,13,0,0.0,0,,noah-kim-1
1499,Omar Shah,Utah,Big 12,12,1,0,0.0,0,0.0,0,0,,0,0.0,1,0,0.0,0,,omar-shah-1
1500,Omari Kelly,Middle Tennessee State,CUSA,11,3,0,0.0,0,0.0,53,869,16.4,4,79.0,56,869,15.5,4,,omari-kelly-1
1501,Oscar Cardenas*,UTSA,American,8,1,0,0.0,0,0.0,13,141,10.8,3,17.6,14,141,10.1,3,,oscar-cardenas-1
1502,Preston Fox*,West Virginia,Big 12,13,1,0,0.0,0,0.0,12,131,10.9,0,10.1,13,131,10.1,0,,preston-fox-1
1503,Quran Boyd*,Duke,ACC,6,2,0,0.0,0,0.0,1,1,1.0,0,0.2,3,1,0.3,0,,quran-boyd-1
1504,Sam Jackson,Auburn,SEC,9,2,0,0.0,0,0.0,2,63,31.5,1,7.0,4,63,15.8,1,,sam-jackson-3
1505,Sherman Smith,Houston,Big 12,1,1,0,0.0,0,0.0,0,0,,0,0.0,1,0,0.0,0,,sherman-smith-3
1506,Timmy Ward*,Rutgers,Big Ten,12,1,0,0.0,0,0.0,0,0,,0,0.0,1,0,0.0,0,,timmy-ward-1
1507,Tovani Mizell,Kentucky,SEC,1,1,0,0.0,0,0.0,0,0,,0,0.0,1,0,0.0,0,,tovani-mizell-1
1508,Carter Nelson*,Nebraska,Big Ten,13,2,-1,-0.5,0,-0.1,10,86,8.6,1,6.6,12,85,7.1,1,,carter-nelson-1
1509,Chris Barnes*,Washington State,Ind,3,1,-1,-1.0,0,-0.3,2,19,9.5,0,6.3,3,18,6.0,0,,chris-barnes-7
1510,DeVon Rice*,Kansas State,Big 12,4,1,-1,-1.0,0,-0.3,0,0,,0,0.0,1,-1,-1.0,0,,devon-rice-1
1511,Jaden Smith,UTEP,CUSA,4,1,-1,-1.0,0,-0.3,21,177,8.4,0,44.3,22,176,8.0,0,,jaden-smith-4
1512,Jake Jensen*,USC,Big Ten,2,1,-1,-1.0,0,-0.5,0,0,,0,0.0,1,-1,-1.0,0,,jake-jensen-1
1513,Jake Wilson,Wyoming,MWC,4,1,-1,-1.0,0,-0.3,0,0,,0,0.0,1,-1,-1.0,0,,jake-wilson-5
1514,Jermiah Salem,Eastern Michigan,MAC,3,4,-1,-0.3,0,-0.3,0,0,,0,0.0,4,-1,-0.3,0,,jermiah-salem-1
1515,JR Blood*,Missouri,SEC,1,1,-1,-1.0,0,-1.0,0,0,,0,0.0,1,-1,-1.0,0,,jr-blood-1
1516,Kaden Prather,Maryland,Big Ten,12,1,-1,-1.0,0,-0.1,56,624,11.1,4,52.0,57,623,10.9,4,,kaden-prather-1
1517,Kellan Wyatt,Maryland,Big Ten,11,1,-1,-1.0,0,-0.1,0,0,,0,0.0,1,-1,-1.0,0,,kellan-wyatt-1
1518,Keona Peat,Arizona State,Big 12,1,1,-1,-1.0,0,-1.0,0,0,,0,0.0,1,-1,-1.0,0,,keona-peat-1
1519,Simon Wilson,Middle Tennessee State,CUSA,12,1,-1,-1.0,0,-0.1,0,0,,0,0.0,1,-1,-1.0,0,,simon-wilson-1
1520,Tailique Williams,Georgia State,Sun Belt,4,1,-1,-1.0,0,-0.3,16,165,10.3,0,41.3,17,164,9.6,0,,tailique-williams-1
1521,Tez Johnson,Oregon,Big Ten,12,1,-1,-1.0,0,-0.1,83,898,10.8,10,74.8,84,897,10.7,10,,tez-johnson-1
1522,Tiger Bachmeier,Stanford,ACC,12,1,-1,-1.0,0,-0.1,10,67,6.7,0,5.6,11,66,6.0,0,,tiger-bachmeier-1
1523,Trevor Wilson,Kansas,Big 12,12,3,-1,-0.3,0,-0.1,9,139,15.4,0,11.6,12,138,11.5,0,,trevor-wilson-1
1524,Avery Boyd*,Georgia Tech,ACC,13,1,-2,-2.0,0,-0.2,25,316,12.6,2,24.3,26,314,12.1,2,,avery-boyd-1
1525,Beau Sparks*,Texas State,Sun Belt,13,1,-2,-2.0,0,-0.2,25,271,10.8,2,20.8,26,269,10.3,2,,beau-sparks-1
1526,Brian Buschini*,Nebraska,Big Ten,13,1,-2,-2.0,0,-0.2,0,0,,0,0.0,1,-2,-2.0,0,,brian-buschini-1
1527,Bryce Bohanon*,Tulane,American,14,1,-2,-2.0,0,-0.1,10,121,12.1,0,8.6,11,119,10.8,0,,bryce-bohanon-1
1528,Cade McConnell,UTEP,CUSA,6,14,-2,-0.1,0,-0.3,0,0,,0,0.0,14,-2,-0.1,0,,cade-mcconnell-2
1529,Colston Loveland*,Michigan,Big Ten,10,1,-2,-2.0,0,-0.2,56,582,10.4,5,58.2,57,580,10.2,5,,colston-loveland-1
1530,Jeremiah Patterson,Arizona,Big 12,12,2,-2,-1.0,0,-0.2,26,196,7.5,2,16.3,28,194,6.9,2,,jeremiah-patterson-1
1531,Jonah Dalmas,Boise State,MWC,14,1,-2,-2.0,0,-0.1,0,0,,0,0.0,1,-2,-2.0,0,,jonah-dalmas-1
1532,Joseph Manjack IV,Houston,Big 12,11,1,-2,-2.0,0,-0.2,22,351,16.0,3,31.9,23,349,15.2,3,,joseph-manjack-iv-1
1533,Khalib Johnson,Kennesaw State,CUSA,4,6,-2,-0.3,0,-0.5,0,0,,0,0.0,6,-2,-0.3,0,,khalib-johnson-1
1534,Landon Wells*,Vanderbilt,SEC,1,1,-2,-2.0,0,-2.0,0,0,,0,0.0,1,-2,-2.0,0,,landon-wells-1
1535,Logan Kyle*,James Madison,Sun Belt,13,1,-2,-2.0,0,-0.2,11,132,12.0,1,10.2,12,130,10.8,1,,logan-kyle-1
1536,Nathan Schuessler*,Coastal Carolina,Sun Belt,2,1,-2,-2.0,0,-1.0,0,0,,0,0.0,1,-2,-2.0,0,,nathan-schuessler-1
1537,Paddy Turner*,Colorado State,MWC,13,1,-2,-2.0,0,-0.2,0,0,,0,0.0,1,-2,-2.0,0,,paddy-turner-1
1538,Tyler Brown,Clemson,ACC,6,1,-2,-2.0,0,-0.3,5,30,6.0,0,5.0,6,28,4.7,0,,tyler-brown-7
1539,Addison Ostrenga*,Iowa,Big Ten,8,1,-3,-3.0,0,-0.4,15,114,7.6,1,14.3,16,111,6.9,1,,addison-ostrenga-1
1540,Alberto Mendoza,Indiana,Big Ten,1,2,-3,-1.5,0,-3.0,0,0,,0,0.0,2,-3,-1.5,0,,alberto-mendoza-1
1541,Alex Walker*,Coastal Carolina,Sun Belt,2,1,-3,-3.0,0,-1.5,0,0,,0,0.0,1,-3,-3.0,0,,alex-walker-4
1542,Arrington Maiden*,Memphis,American,1,1,-3,-3.0,0,-3.0,0,0,,0,0.0,1,-3,-3.0,0,,arrington-maiden-1
1543,Benjamin Roy Jr.,Massachusetts,Ind,11,1,-3,-3.0,0,-0.3,0,0,,0,0.0,1,-3,-3.0,0,,benjamin-roy-jr-1
1544,Carston Kieffer,Arizona State,Big 12,7,1,-3,-3.0,0,-0.4,0,0,,0,0.0,1,-3,-3.0,0,,carston-kieffer-1
1545,Deuce Hogan,New Mexico State,CUSA,2,4,-3,-0.8,0,-1.5,0,0,,0,0.0,4,-3,-0.8,0,,deuce-hogan-1
1546,Dorian Fleming,Georgia State,Sun Belt,12,1,-3,-3.0,0,-0.3,49,558,11.4,6,46.5,50,555,11.1,6,,dorian-fleming-1
1547,Elijah Metcalf,Marshall,Sun Belt,5,2,-3,-1.5,0,-0.6,20,194,9.7,3,38.8,22,191,8.7,3,,elijah-metcalf-1
1548,Eric Rivers,Florida International,CUSA,12,1,-3,-3.0,0,-0.3,62,1172,18.9,12,97.7,63,1169,18.6,12,,eric-rivers-2
1549,Jake Bailey,SMU,ACC,8,1,-3,-3.0,0,-0.4,19,275,14.5,1,34.4,20,272,13.6,1,,jake-bailey-2
1550,James Allen,Georgia State,Sun Belt,12,2,-3,-1.5,0,-0.3,0,0,,0,0.0,2,-3,-1.5,0,,james-allen-5
1551,Lonnie Adksim*,Sam Houston,CUSA,10,1,-3,-3.0,0,-0.3,1,4,4.0,0,0.4,2,1,0.5,0,,lonnie-adksim-1
1552,Peyton Higgins,Troy,Sun Belt,12,1,-3,-3.0,0,-0.3,31,301,9.7,1,25.1,32,298,9.3,1,,peyton-higgins-1
1553,Raphael Williams*,Pitt,ACC,13,1,-3,-3.0,0,-0.2,37,426,11.5,6,32.8,38,423,11.1,6,,raphael-williams-1
1554,Silas Bolden*,Texas,SEC,16,2,-3,-1.5,1,-0.2,23,267,11.6,1,16.7,25,264,10.6,2,,silas-bolden-1
1555,Ui Ale,Houston,Big 12,2,3,-3,-1.0,0,-1.5,0,0,,0,0.0,3,-3,-1.0,0,,ui-ale-1
1556,Cole Tannenbaum,Arizona,Big 12,4,1,-4,-4.0,0,-1.0,0,0,,0,0.0,1,-4,-4.0,0,,cole-tannenbaum-1
1557,Demeer Blankumsee*,Memphis,American,13,2,-4,-2.0,0,-0.3,45,677,15.0,6,52.1,47,673,14.3,6,,demeer-blankumsee-1
1558,Jacob Conover,Utah State,MWC,2,3,-4,-1.3,0,-2.0,0,0,,0,0.0,3,-4,-1.3,0,,jacob-conover-1
1559,Jarius Mack,Charlotte,American,12,1,-4,-4.0,0,-0.3,19,418,22.0,0,34.8,20,414,20.7,0,,jarius-mack-1
1560,Jayden Mandal*,Fresno State,MWC,6,2,-4,-2.0,0,-0.7,0,0,,0,0.0,2,-4,-2.0,0,,jayden-mandal-1
1561,Kitan Crawford,Nevada,MWC,13,1,-4,-4.0,0,-0.3,1,6,6.0,0,0.5,2,2,1.0,0,,kitan-crawford-1
1562,Malcolm Johnson Jr.*,Bowling Green,MAC,13,1,-4,-4.0,0,-0.3,49,569,11.6,3,43.8,50,565,11.3,3,,malcolm-johnson-jr-1
1563,Matt Sykes,Rice,American,12,2,-4,-2.0,0,-0.3,65,782,12.0,5,65.2,67,778,11.6,5,,matt-sykes-1
1564,Mekhi Miller*,Missouri,SEC,12,1,-4,-4.0,0,-0.3,3,35,11.7,0,2.9,4,31,7.8,0,,mekhi-miller-1
1565,Phoenix Moss,Georgia State,Sun Belt,3,2,-4,-2.0,0,-1.3,0,0,,0,0.0,2,-4,-2.0,0,,phoenix-moss-1
1566,Ryan Hilinski,Northwestern,Big Ten,4,2,-4,-2.0,0,-1.0,0,0,,0,0.0,2,-4,-2.0,0,,ryan-hilinski-1
1567,Tyseer Denmark*,Penn State,Big Ten,4,1,-4,-4.0,0,-1.0,2,28,14.0,1,7.0,3,24,8.0,1,,tyseer-denmark-1
1568,AJ Hairston,Massachusetts,Ind,4,24,-5,-0.2,1,-1.3,0,0,,0,0.0,24,-5,-0.2,1,,aj-hairston-1
1569,Ben Furtney,Purdue,Big Ten,12,1,-5,-5.0,0,-0.4,0,0,,0,0.0,1,-5,-5.0,0,,ben-furtney-1
1570,Devan Williams,Houston,Big 12,12,1,-5,-5.0,0,-0.4,11,127,11.5,1,10.6,12,122,10.2,1,,devan-williams-1
1571,Ja'Shaun Poke,San Diego State,MWC,12,4,-5,-1.3,0,-0.4,50,459,9.2,1,38.3,54,454,8.4,1,,jashaun-poke-2
1572,Jordan Napier,San Diego State,MWC,12,3,-5,-1.7,0,-0.4,43,440,10.2,4,36.7,46,435,9.5,4,,jordan-napier-1
1573,Mack West*,Coastal Carolina,Sun Belt,13,1,-5,-5.0,0,-0.4,0,0,,0,0.0,1,-5,-5.0,0,,mack-west-1
1574,Marques Hicks,Kent State,MAC,2,3,-5,-1.7,0,-2.5,0,0,,0,0.0,3,-5,-1.7,0,,marques-hicks-1
1575,Michael Phoenix II*,Sam Houston,CUSA,12,3,-5,-1.7,0,-0.4,15,219,14.6,3,18.3,18,214,11.9,3,,michael-phoenix-ii-1
1576,Alec Clark,Marshall,Sun Belt,13,1,-6,-6.0,0,-0.5,0,0,,0,0.0,1,-6,-6.0,0,,alec-clark-1
1577,Cedric Hawkins*,Arkansas State,Sun Belt,3,2,-6,-3.0,0,-2.0,0,0,,0,0.0,2,-6,-3.0,0,,cedric-hawkins-1
1578,Darrius Clemons,Oregon State,Ind,9,2,-6,-3.0,0,-0.7,25,292,11.7,2,32.4,27,286,10.6,2,,darrius-clemons-1
1579,Kameron Courtney,Virginia,ACC,9,2,-6,-3.0,0,-0.7,12,114,9.5,0,12.7,14,108,7.7,0,,kameron-courtney-1
1580,Ben Gulbranson,Oregon State,Ind,5,14,-7,-0.5,1,-1.4,0,0,,0,0.0,14,-7,-0.5,1,,ben-gulbranson-1
1581,Squirrel White,Tennessee,SEC,13,1,-7,-7.0,0,-0.5,34,381,11.2,2,29.3,35,374,10.7,2,,squirrel-white-1
1582,Sterling Galban,Massachusetts,Ind,12,1,-7,-7.0,0,-0.6,25,210,8.4,0,17.5,26,203,7.8,0,,sterling-galban-1
1583,Tyrane Stewart*,North Carolina,ACC,10,1,-7,-7.0,0,-0.7,0,0,,0,0.0,1,-7,-7.0,0,,tyrane-stewart-1
1584,Wyatt Young*,North Texas,American,13,3,-7,-2.3,1,-0.5,18,295,16.4,2,22.7,21,288,13.7,3,,wyatt-young-2
1585,Aidan Warner*,Florida,SEC,6,8,-8,-1.0,1,-1.3,0,0,,0,0.0,8,-8,-1.0,1,,aidan-warner-1
1586,Bauer Sharp*,Oklahoma,SEC,12,2,-8,-4.0,0,-0.7,42,324,7.7,2,27.0,44,316,7.2,2,,bauer-sharp-1
1587,Chris Culliver*,North Carolina,ACC,12,1,-8,-8.0,0,-0.7,6,135,22.5,1,11.3,7,127,18.1,1,,chris-culliver-2
1588,D.J. Uiagalelei,Florida State,ACC,5,37,-8,-0.2,0,-1.6,0,0,,0,0.0,37,-8,-0.2,0,,dj-uiagalelei-1
1589,Jacolby George*,Miami (FL),ACC,13,2,-8,-4.0,0,-0.6,53,752,14.2,8,57.8,55,744,13.5,8,,jacolby-george-1
1590,John-Keawe Sagapolutele,Hawaii,MWC,5,2,-8,-4.0,0,-1.6,0,0,,0,0.0,2,-8,-4.0,0,,john-keawe-sagapolutele-1
1591,Michael Johnson Jr.*,Syracuse,ACC,1,4,-8,-2.0,0,-8.0,0,0,,0,0.0,4,-8,-2.0,0,,michael-johnson-jr-1
1592,Armani Winfield*,Colorado State,MWC,13,1,-9,-9.0,0,-0.7,38,341,9.0,2,26.2,39,332,8.5,2,,armani-winfield-1
1593,Braden Bohannon,Kennesaw State,CUSA,5,5,-9,-1.8,0,-1.8,0,0,,0,0.0,5,-9,-1.8,0,,braden-bohannon-1
1594,Brice Busch*,Tulane,American,14,1,-9,-9.0,0,-0.6,0,0,,0,0.0,1,-9,-9.0,0,,brice-busch-1
1595,Champ Long,Maryland,Big Ten,1,1,-9,-9.0,0,-9.0,0,0,,0,0.0,1,-9,-9.0,0,,champ-long-1
1596,Jacob Stewart*,San Jose State,MWC,13,1,-9,-9.0,0,-0.7,34,287,8.4,3,22.1,35,278,7.9,3,,jacob-stewart-2
1597,Justyn Martin,UCLA,Big Ten,3,8,-9,-1.1,0,-3.0,0,0,,0,0.0,8,-9,-1.1,0,,justyn-martin-1
1598,Maealiuaki Smith,Oklahoma State,Big 12,4,15,-9,-0.6,1,-2.3,0,0,,0,0.0,15,-9,-0.6,1,,maealiuaki-smith-1
1599,Nick Nash*,San Jose State,MWC,12,1,-9,-9.0,0,-0.8,104,1382,13.3,16,115.2,105,1373,13.1,16,AA,nick-nash-1
1600,Ryan Eckley,Michigan State,Big Ten,12,1,-9,-9.0,0,-0.8,0,0,,0,0.0,1,-9,-9.0,0,,ryan-eckley-1
1601,Kenny Odom,UTEP,CUSA,12,4,-10,-2.5,0,-0.8,46,741,16.1,8,61.8,50,731,14.6,8,,kenny-odom-1
1602,Shay Smith,UTEP,CUSA,4,6,-10,-1.7,1,-2.5,0,0,,0,0.0,6,-10,-1.7,1,,shay-smith-1
1603,Avery Book,Akron,MAC,12,1,-11,-11.0,0,-0.9,0,0,,0,0.0,1,-11,-11.0,0,,avery-book-1
1604,Dalvin Smith*,Western Kentucky,CUSA,14,1,-11,-11.0,0,-0.8,31,406,13.1,4,29.0,32,395,12.3,4,,dalvin-smith-1
1605,Jordan Smith,New Mexico State,CUSA,10,2,-11,-5.5,0,-1.1,8,110,13.8,0,11.0,10,99,9.9,0,,jordan-smith-11
1606,Malachi Nelson,Boise State,MWC,3,2,-11,-5.5,0,-3.7,0,0,,0,0.0,2,-11,-5.5,0,,malachi-nelson-1
1607,Larry Simmons,Southern Mississippi,Sun Belt,12,2,-12,-6.0,0,-1.0,27,421,15.6,1,35.1,29,409,14.1,1,,larry-simmons-3
1608,Michael Van Buren Jr.,Mississippi State,SEC,10,69,-12,-0.2,5,-1.2,0,0,,0,0.0,69,-12,-0.2,5,,michael-van-buren-jr-1
1609,Brady Lichtenberg,Cincinnati,Big 12,3,6,-13,-2.2,0,-4.3,0,0,,0,0.0,6,-13,-2.2,0,,brady-lichtenberg-1
1610,Gunner Stockton,Georgia,SEC,5,21,-13,-0.6,0,-2.6,0,0,,0,0.0,21,-13,-0.6,0,,gunner-stockton-1
1611,Isaiah Chavez,New Mexico,MWC,11,2,-13,-6.5,0,-1.2,0,0,,0,0.0,2,-13,-6.5,0,,isaiah-chavez-1
1612,Jack Stonehouse*,Syracuse,ACC,13,1,-13,-13.0,0,-1.0,0,0,,0,0.0,1,-13,-13.0,0,,jack-stonehouse-1
1613,Jordan Shipp*,North Carolina,ACC,12,1,-13,-13.0,0,-1.1,9,114,12.7,1,9.5,10,101,10.1,1,,jordan-shipp-1
1614,Kendrick Bell*,Michigan,Big Ten,13,1,-13,-13.0,0,-1.0,7,70,10.0,0,5.4,8,57,7.1,0,,kendrick-bell-3
1615,David Lynch*,Pitt,ACC,3,4,-14,-3.5,0,-4.7,0,0,,0,0.0,4,-14,-3.5,0,,david-lynch-1
1616,Lucas Scheerhorn,Kennesaw State,CUSA,3,1,-14,-14.0,0,-4.7,0,0,,0,0.0,1,-14,-14.0,0,,lucas-scheerhorn-1
1617,Grayson Barnes*,Northern Illinois,MAC,13,3,-15,-5.0,0,-1.2,31,338,10.9,4,26.0,34,323,9.5,4,,grayson-barnes-1
1618,Ryan Boe,Northwestern,Big Ten,1,1,-15,-15.0,0,-15.0,0,0,,0,0.0,1,-15,-15.0,0,,ryan-boe-1
1619,Alec Bevelhimer*,Miami (OH),MAC,14,1,-16,-16.0,0,-1.1,0,0,,0,0.0,1,-16,-16.0,0,,alec-bevelhimer-1
1620,Tommy Maher*,Colorado State,MWC,5,2,-16,-8.0,0,-3.2,4,99,24.8,1,19.8,6,83,13.8,1,,tommy-maher-1
1621,Kirk Francis,Tulsa,American,11,34,-18,-0.5,0,-1.6,0,0,,0,0.0,34,-18,-0.5,0,,kirk-francis-1
1622,Miller Moss*,USC,Big Ten,9,21,-18,-0.9,2,-2.0,0,0,,0,0.0,21,-18,-0.9,2,,miller-moss-1
1623,Alex Bacchetta,Rice,American,12,1,-19,-19.0,0,-1.6,0,0,,0,0.0,1,-19,-19.0,0,,alex-bacchetta-1
1624,Josh Hoover*,Texas Christian,Big 12,13,47,-19,-0.4,4,-1.5,0,0,,0,0.0,47,-19,-0.4,4,,josh-hoover-1
1625,Behren Morton*,Texas Tech,Big 12,12,55,-22,-0.4,1,-1.8,0,0,,0,0.0,55,-22,-0.4,1,,behren-morton-1
1626,Davis Warren*,Michigan,Big Ten,9,17,-22,-1.3,0,-2.4,0,0,,0,0.0,17,-22,-1.3,0,,davis-warren-1
1627,Guy Gillespie,Nevada,MWC,13,2,-22,-11.0,0,-1.7,0,0,,0,0.0,2,-22,-11.0,0,,guy-gillespie-1
1628,Tommy Ulatowski,Kent State,MAC,10,62,-22,-0.4,1,-2.2,0,0,,0,0.0,62,-22,-0.4,1,,tommy-ulatowski-1
1629,Elijah Brown,Stanford,ACC,3,14,-23,-1.6,0,-7.7,0,0,,0,0.0,14,-23,-1.6,0,,elijah-brown-5
1630,Emmett Brown*,San Jose State,MWC,9,26,-23,-0.9,1,-2.6,0,0,,0,0.0,26,-23,-0.9,1,,emmett-brown-1
1631,James Evans,Indiana,Big Ten,13,1,-23,-23.0,0,-1.8,0,0,,0,0.0,1,-23,-23.0,0,,james-evans-2
1632,Hudson Card,Purdue,Big Ten,10,46,-27,-0.6,0,-2.7,1,-7,-7.0,0,-0.7,47,-34,-0.7,0,,hudson-card-1
1633,Cade McNamara*,Iowa,Big Ten,8,13,-31,-2.4,0,-3.9,0,0,,0,0.0,13,-31,-2.4,0,,cade-mcnamara-1
1634,Devin Kargman,Kent State,MAC,4,11,-31,-2.8,0,-7.8,0,0,,0,0.0,11,-31,-2.8,0,,devin-kargman-1
1635,Michael Merdinger*,North Carolina,ACC,1,5,-31,-6.2,0,-31.0,0,0,,0,0.0,5,-31,-6.2,0,,michael-merdinger-1
1636,Jadyn Glasser,Central Michigan,MAC,4,21,-35,-1.7,1,-8.8,0,0,,0,0.0,21,-35,-1.7,1,,jadyn-glasser-1
1637,Kurtis Rourke,Indiana,Big Ten,12,46,-35,-0.8,2,-2.9,0,0,,0,0.0,46,-35,-0.8,2,H-9,kurtis-rourke-1
1638,Max Brosmer*,Minnesota,Big Ten,13,71,-36,-0.5,5,-2.8,0,0,,0,0.0,71,-36,-0.5,5,,max-brosmer-1
1639,Alan Bowman,Oklahoma State,Big 12,11,24,-38,-1.6,0,-3.5,1,11,11.0,1,1.0,25,-27,-1.1,1,,alan-bowman-1
1640,Garrett Nussmeier*,LSU,SEC,13,34,-38,-1.1,3,-2.9,0,0,,0,0.0,34,-38,-1.1,3,,garrett-nussmeier-1
1641,Cutter Boley,Kentucky,SEC,4,10,-43,-4.3,0,-10.8,0,0,,0,0.0,10,-43,-4.3,0,,cutter-boley-1
1642,Shedeur Sanders*,Colorado,Big 12,13,100,-50,-0.5,4,-3.8,0,0,,0,0.0,100,-50,-0.5,4,H-8,shedeur-sanders-1
1643,Tommy Schuster,Michigan State,Big Ten,5,8,-51,-6.4,1,-10.2,0,0,,0,0.0,8,-51,-6.4,1,,tommy-schuster-1
1644,John White,Southern Mississippi,Sun Belt,4,11,-52,-4.7,1,-13.0,0,0,,0,0.0,11,-52,-4.7,1,,john-white-14
1645,Jalen Kitna,UAB,American,8,45,-60,-1.3,0,-7.5,1,-9,-9.0,0,-1.1,46,-69,-1.5,0,,jalen-kitna-1
1646,Dylan Raiola*,Nebraska,Big Ten,13,50,-65,-1.3,0,-5.0,0,0,,0,0.0,50,-65,-1.3,0,,dylan-raiola-1
1647,Kyle McCord*,Syracuse,ACC,13,67,-65,-1.0,3,-5.0,0,0,,0,0.0,67,-65,-1.0,3,H-10,kyle-mccord-1
1648,Maalik Murphy*,Duke,ACC,12,19,-79,-4.2,2,-6.6,0,0,,0,0.0,19,-79,-4.2,2,,maalik-murphy-2
1649,Will Rogers*,Washington,Big Ten,11,34,-79,-2.3,0,-7.2,0,0,,0,0.0,34,-79,-2.3,0,,will-rogers-1
1650,Quinn Ewers*,Texas,SEC,14,57,-82,-1.4,2,-5.9,0,0,,0,0.0,57,-82,-1.4,2,,quinn-ewers-1
1651,Kadin Semonza,Ball State,MAC,12,54,-85,-1.6,1,-7.1,2,1,0.5,0,0.1,56,-84,-1.5,1,,kadin-semonza-1
1652,Tate Rodemaker,Southern Mississippi,Sun Belt,9,26,-90,-3.5,0,-10.0,1,42,42.0,0,4.7,27,-48,-1.8,0,,tate-rodemaker-1
1653,Connor Bazelak*,Bowling Green,MAC,13,48,-91,-1.9,2,-7.0,0,0,,0,0.0,48,-91,-1.9,2,,connor-bazelak-1
1654,Hayden Wolff*,Western Michigan,MAC,13,39,-101,-2.6,0,-7.8,0,0,,0,0.0,39,-101,-2.6,0,,hayden-wolff-1
1655,Deshawn Purdie,Charlotte,American,9,41,-130,-3.2,1,-14.4,0,0,,0,0.0,41,-130,-3.2,1,,deshawn-purdie-1
1656,Evan Bullock*,Louisiana Tech,CUSA,12,63,-130,-2.1,1,-10.8,0,0,,0,0.0,63,-130,-2.1,1,,evan-bullock-1
1657,Mikey Keene*,Fresno State,MWC,12,47,-194,-4.1,0,-16.2,0,0,,0,0.0,47,-194,-4.1,0,,mikey-keene-1